"dQ" = (/obj/effect/landmark/test/space_turf,/turf/space,/area/space)
"jS" = (/obj/effect/landmark/map_data{height = 3},/turf/space,/area/space)
"pv" = (/turf/simulated/floor/reinforced/airless,/area/space)
"Lo" = (/turf/space,/area/space)
"Xr" = (/turf/simulated/floor/plating,/area/space)
"Ze" = (/turf/simulated/wall/r_wall/prepainted,/area/space)
"ZX" = (/turf/simulated/open,/area/space)

(1,1,1) = {"
LoLoLoLoLoLoLoLoLoLoLoLoLoLoLoLoLoLoLoLoLoLoLoLoLoLoLoLoLoLoLoLoLoLoLoLoLoLoLoLoLoLoLoLoLoLoLoLoLoLoLoLoLoLoLoLoLoLoLoLoLoLoLoLoLoLoLoLoLoLoLoLoLoLoLoLoLoLoLoLo
LoLoLoLoLoLoLoLoLoLoLoLoLoLoLoLoLoLoLoLoLoLoLoLoLoLoLoLoLoLoLoLoLoLoLoLoLoLoLoLoLoLoLoLoLoLoLoLoLoLoLoLoLoLoLoLoLoLoLoLoLoLoLoLoLoLoLoLoLoLoLoLoLoLoLoLoLoLoLoLo
LoLoLoLoLoLoLoLoLoLoLoLoLoLoLopvpvpvpvpvpvpvpvpvpvpvpvpvpvpvpvpvpvpvpvpvpvpvpvpvpvpvpvpvpvpvpvpvpvpvpvpvpvpvpvpvpvpvpvpvpvpvpvpvpvLoLoLoLoLoLoLoLoLoLoLoLoLoLoLo
LoLoLoLoLoLoLoLoLoLoLoLoLoLoLopvpvpvpvpvpvpvpvpvpvZeZeZeZeZeZeZeZeZeZeZeZeZeZeZeZeZeZeZeZeZeZeZeZeZeZeZeZeZeZepvpvpvpvpvpvpvpvpvpvLoLoLoLoLoLoLoLoLoLoLoLoLoLoLo
LoLoLoLoLoLoLoLoLoLopvpvpvpvpvpvpvpvpvpvpvpvpvpvpvZeZeZeZeZeZeZeZeZeZeZeZeZeZeZeZeZeZeZeZeZeZeZeZeZeZeZeZeZeZepvpvpvpvpvpvpvpvpvpvpvpvpvpvpvLoLoLoLoLoLoLoLoLoLo
LoLoLoLoLoLoLoLoLoLopvpvpvpvpvpvpvpvpvpvpvpvpvpvZeZeZeZeZeZeZeZeZeZeZeZeZeZeZeZeZeZeZeZeZeZeZeZeZeZeZeZeZeZeZeZeZepvpvpvpvpvpvpvpvpvpvpvpvpvLoLoLoLoLoLoLoLoLoLo
LoLoLoLoLoLoLoLoLoLopvpvpvpvpvpvpvpvpvpvpvpvpvpvZeZeZeZeZeZeZeZeZeZeZeZeZeZeZeZeZeZeZeZeZeZeZeZeZeZeZeZeZeZeZeZeZepvpvpvpvpvpvpvpvpvpvpvpvpvLoLoLoLoLoLoLoLoLoLo
LoLoLoLoLoLoLoLoLoLopvpvpvpvpvpvpvpvpvpvpvpvpvpvZeZeZeZeXrXrXrXrXrXrXrXrXrXrXrXrXrXrXrXrXrXrXrXrXrXrZeZeZeZeZeZeZepvpvpvpvpvpvpvpvpvpvpvpvpvLoLoLoLoLoLoLoLoLoLo
LoLoLoLoLoLoLoLoLoLopvpvpvpvpvpvpvpvpvpvpvpvpvZeZeZeZeZeXrXrXrXrXrXrZXZXZXZXXrZXZXZXZXXrZXZXZXZXZXXrZeZeZeZeZeZeZepvpvpvpvpvpvpvpvpvpvpvpvpvLoLoLoLoLoLoLoLoLoLo
LoLoLoLoLoLoLoLoLoLopvpvpvpvpvpvpvpvpvpvpvpvpvZeZeZeZeZeXrXrXrXrXrXrZXZXZXZXXrZXZXZXZXXrZXZXZXZXZXXrZeZeZeZeZeZeZepvpvpvpvpvpvpvpvpvpvpvpvpvLoLoLoLoLoLoLoLoLoLo
LoLoLoLoLoLoLoLoLoLopvpvpvpvpvpvpvpvpvpvpvpvpvZeZeZeZeZeXrXrXrXrXrXrZXZXZXZXXrZXZXZXZXXrXrXrXrXrXrXrZeZeZeZeZeZeZepvpvpvpvpvpvpvpvpvpvpvpvpvLoLoLoLoLoLoLoLoLoLo
LoLoLoLoLoLoLoLoLoLopvpvpvpvpvpvpvpvpvpvpvpvZeZeZeZeZeZeXrXrXrXrXrXrZXZXZXZXXrZXZXZXZXXrZXZXZXZXZXXrZeZeZeZeZeZeZepvpvpvpvpvpvpvpvpvpvpvpvpvLoLoLoLoLoLoLoLoLoLo
LoLoLoLoLoLoLoLoLoLopvpvpvpvpvpvpvpvpvpvpvpvZeZeZeZeZeZeXrXrXrXrXrXrZXZXZXZXXrZXZXZXZXXrZXZXZXZXZXXrZeZeZeZeZeZeZepvpvpvpvpvpvpvpvpvpvpvpvpvLoLoLoLoLoLoLoLoLoLo
LoLoLoLoLoLoLoLoLoLopvpvpvpvpvpvpvpvpvpvpvpvZeZeZeZeZeZeXrXrXrXrXrXrZXZXZXZXXrZXZXZXZXXrZXZXZXZXZXXrZeZeZeZeZeZeZepvpvpvpvpvpvpvpvpvpvpvpvpvLoLoLoLoLoLoLoLoLoLo
LoLoLoLoLoLoLoLoLoLopvpvpvpvpvpvpvpvpvpvpvpvZeZeZeZeZeZeXrXrXrXrXrXrXrXrXrXrXrXrXrXrXrXrXrXrZXZXZXXrZeZeZeZeZeZeZepvpvpvpvpvpvpvpvpvpvpvpvpvLoLoLoLoLoLoLoLoLoLo
LoLoLoLoLoLoLoLoLoLopvpvpvpvpvpvpvpvpvpvpvpvZeZeZeZeZeZeXrXrXrXrXrXrZXZXZXZXXrZXZXZXZXZXZXXrZXZXZXXrZeZeZeZeZeZeZepvpvpvpvpvpvpvpvpvpvpvpvpvLoLoLoLoLoLoLoLoLoLo
LoLoLoLoLoLoLoLoLoLopvpvpvpvpvpvpvpvpvpvpvpvZeZeZeZeZeZeXrXrXrXrXrXrZXZXZXZXXrZXZXZXZXZXZXXrZXZXZXXrZeZeZeZeZeZeZepvpvpvpvpvpvpvpvpvpvpvpvpvLoLoLoLoLoLoLoLoLoLo
LoLoLoLoLoLoLoLoLoLopvpvpvpvpvpvpvpvpvpvpvpvZeZeZeZeZeZeXrXrXrXrXrXrZXZXZXZXXrZXZXZXZXZXZXXrZXZXZXXrZeZeZeZeZeZeZepvpvpvpvpvpvpvpvpvpvpvpvpvLoLoLoLoLoLoLoLoLoLo
LoLoLoLoLoLoLoLoLoLopvpvpvpvpvpvpvpvpvpvpvpvZeZeZeZeZeZeXrXrXrXrXrXrZXZXZXZXXrZXZXZXZXZXZXXrZXZXZXXrZeZeZeZeZeZeZeZeZepvpvpvpvpvpvpvpvpvpvpvLoLoLoLoLoLoLoLoLoLo
LoLoLoLoLoLoLoLoLoLopvpvpvpvpvpvpvpvpvpvpvpvZeZeZeZeZeZeXrXrXrXrXrXrZXZXZXZXXrZXZXZXZXZXZXXrZXZXZXXrZeZeZeZeZeZeZeZeZepvpvpvpvpvpvpvpvpvpvpvLoLoLoLoLoLoLoLoLoLo
LoLoLoLoLoLoLoLoLoLopvpvpvpvpvpvpvpvpvpvpvpvZeZeZeZeZeZeXrXrXrXrXrXrXrXrXrXrXrXrXrXrXrXrXrXrZXZXZXXrZeZeZeZeZeZeZeZeZepvpvpvpvpvpvpvpvpvpvpvLoLoLoLoLoLoLoLoLoLo
LoLoLoLoLoLoLoLoLoLopvpvpvpvpvpvpvpvpvpvpvpvZeZeZeZeZeZeXrXrXrXrXrXrZXZXZXZXZXZXZXZXZXZXZXXrZXZXZXXrZeZeZeZeZeZeZeZeZepvpvpvpvpvpvpvpvpvpvpvLoLoLoLoLoLoLoLoLoLo
LoLoLoLoLoLoLoLoLoLopvpvpvpvpvpvpvpvpvpvpvpvZeZeZeZeZeZeXrXrXrXrXrXrZXZXZXZXZXZXZXZXZXZXZXXrZXZXZXXrZeZeZeZeZeZeZeZeZepvpvpvpvpvpvpvpvpvpvpvLoLoLoLoLoLoLoLoLoLo
LoLoLoLoLoLoLoLoLoLopvpvpvpvpvpvpvpvpvpvpvpvZeZeZeZeZeZeXrXrXrXrXrXrZXZXZXZXZXZXZXZXZXZXZXXrZXZXZXXrZeZeZeZeZeZeZeZeZepvpvpvpvpvpvpvpvpvpvpvLoLoLoLoLoLoLoLoLoLo
LoLoLoLoLoLoLoLoLoLopvpvpvpvpvpvpvpvpvpvpvpvZeZeZeZeZeZeXrXrXrXrXrXrZXZXZXZXZXZXZXZXZXZXZXXrZXZXZXXrZeZeZeZeZeZeZeZeZepvpvpvpvpvpvpvpvpvpvpvLoLoLoLoLoLoLoLoLoLo
LoLoLoLoLoLoLoLoLoLopvpvpvpvpvpvpvpvpvpvpvpvZeZeZeZeZeZeXrXrXrXrXrXrZXZXZXZXZXZXZXZXZXZXZXXrZXZXZXXrZeZeZeZeZeZeZeZeZepvpvpvpvpvpvpvpvpvpvpvLoLoLoLoLoLoLoLoLoLo
LoLoLoLoLoLoLoLoLoLopvpvpvpvpvpvpvpvpvpvpvpvZeZeZeZeZeZeXrXrXrXrXrXrZXZXZXZXZXZXZXZXZXZXZXXrZXZXZXXrZeZeZeZeZeZeZeZeZepvpvpvpvpvpvpvpvpvpvpvLoLoLoLoLoLoLoLoLoLo
LoLoLoLoLoLoLoLoLoLopvpvpvpvpvpvpvpvpvpvpvpvZeZeZeZeZeZeXrXrXrXrXrXrZXZXZXZXZXZXZXZXZXZXZXXrZXZXZXXrZeZeZeZeZeZeZeZeZepvpvpvpvpvpvpvpvpvpvpvLoLoLoLoLoLoLoLoLoLo
LoLoLoLoLoLoLoLoLoLopvpvpvpvpvpvpvpvpvpvpvpvZeZeZeZeZeZeXrXrXrXrXrXrZXZXZXZXZXZXZXZXZXZXZXXrZXZXZXXrZeZeZeZeZeZeZeZeZepvpvpvpvpvpvpvpvpvpvpvLoLoLoLoLoLoLoLoLoLo
LoLoLoLoLoLoLoLoLoLopvpvpvpvpvpvpvpvpvpvpvpvZeZeZeZeZeZeXrXrXrXrXrXrZXZXZXZXZXZXZXZXZXZXZXXrZXZXZXXrZeZeZeZeZeZeZeZeZeZepvpvpvpvpvpvpvpvpvpvLoLoLoLoLoLoLoLoLoLo
LoLoLoLoLoLoLoLoLoLopvpvpvpvpvpvpvpvpvpvpvpvZeZeZeZeZeZeXrXrXrXrXrXrZXZXZXZXZXZXZXZXZXZXZXXrZXZXZXXrZeZeZeZeZeZeZeZeZeZepvpvpvpvpvpvpvpvpvpvLoLoLoLoLoLoLoLoLoLo
LoLoLoLoLoLoLoLoLoLopvpvpvpvpvpvpvpvpvpvpvpvZeZeZeZeZeZeXrXrXrXrXrXrZXZXZXZXZXZXZXZXZXZXZXXrZXZXZXXrZeZeZeZeZeZeZeZeZeZepvpvpvpvpvpvpvpvpvpvLoLoLoLoLoLoLoLoLoLo
LoLoLoLoLoLoLoLoLoLopvpvpvpvpvpvpvpvpvpvpvpvZeZeZeZeZeZeXrXrXrXrXrXrZXZXZXZXZXZXZXZXZXZXZXXrZXZXZXXrZeZeZeZeZeZeZeZeZeZepvpvpvpvpvpvpvpvpvpvLoLoLoLoLoLoLoLoLoLo
LoLoLoLoLoLoLoLoLoLopvpvpvpvpvpvpvpvpvpvpvpvZeZeZeZeZeZeXrXrXrXrXrXrZXZXZXZXZXZXZXZXXrXrXrXrZXZXZXXrZeZeZeZeZeZeZeZeZeZepvpvpvpvpvpvpvpvpvpvLoLoLoLoLoLoLoLoLoLo
LoLoLoLoLoLoLoLoLoLopvpvpvpvpvpvpvpvpvpvpvpvZeZeZeZeZeZeXrXrXrXrXrXrZXZXZXZXZXZXZXZXXrZXZXZXZXZXZXXrZeZeZeZeZeZeZeZeZeZepvpvpvpvpvpvpvpvpvpvLoLoLoLoLoLoLoLoLoLo
LoLoLoLoLoLoLoLoLoLopvpvpvpvpvpvpvpvpvpvpvpvZeZeZeZeZeZeXrXrXrXrXrXrZXZXZXZXZXZXZXZXXrZXZXZXZXZXZXXrZeZeZeZeZeZeZeZeZeZepvpvpvpvpvpvpvpvpvpvLoLoLoLoLoLoLoLoLoLo
LoLoLoLoLoLoLoLoLoLopvpvpvpvpvpvpvpvpvpvpvpvZeZeZeZeZeZeXrXrXrXrXrXrZXZXZXZXZXZXZXZXXrZXZXZXZXZXZXXrZeZeZeZeZeZeZeZeZeZepvpvpvpvpvpvpvpvpvpvLoLoLoLoLoLoLoLoLoLo
LoLoLoLoLoLoLoLoLoLopvpvpvpvpvpvpvpvpvpvpvpvZeZeZeZeZeZeXrXrXrXrXrXrXrXrXrXrXrXrXrXrXrXrXrXrXrXrXrXrZeZeZeZeZeZeZeZeZeZepvpvpvpvpvpvpvpvpvpvLoLoLoLoLoLoLoLoLoLo
LoLoLoLoLoLoLoLoLoLopvpvpvpvpvpvpvpvpvpvpvpvZeZeZeZeZeZeXrXrXrXrXrXrZXZXZXZXZXZXZXZXXrZXZXZXZXZXZXXrZeZeZeZeZeZeZeZeZeZeZepvpvpvpvpvpvpvpvpvLoLoLoLoLoLoLoLoLoLo
LoLoLoLoLoLoLoLoLoLopvpvpvpvpvpvpvpvpvpvpvpvZeZeZeZeZeZeXrXrXrXrXrXrZXZXZXZXZXZXZXZXXrZXZXZXZXZXZXXrZeZeZeZeZeZeZeZeZeZeZepvpvpvpvpvpvpvpvpvLoLoLoLoLoLoLoLoLoLo
LoLoLoLoLoLoLoLoLoLopvpvpvpvpvpvpvpvpvpvpvpvZeZeZeZeZeZeXrXrXrXrXrXrZXZXZXZXZXZXZXZXXrZXZXZXZXZXZXXrZeZeZeZeZeZeZeZeZeZeZepvpvpvpvpvpvpvpvpvLoLoLoLoLoLoLoLoLoLo
LoLoLoLoLoLoLoLoLoLopvpvpvpvpvpvpvpvpvpvpvpvZeZeZeZeZeZeXrXrXrXrXrXrZXZXZXZXZXZXZXZXXrZXZXZXZXZXZXXrZeZeZeZeZeZeZeZeZeZeZepvpvpvpvpvpvpvpvpvLoLoLoLoLoLoLoLoLoLo
LoLoLoLoLoLoLoLoLoLopvpvpvpvpvpvpvpvpvpvpvpvZeZeZeZeZeZeXrXrXrXrXrXrXrXrXrXrXrXrXrXrXrXrXrXrXrXrZXXrZeZeZeZeZeZeZeZeZeZeZepvpvpvpvpvpvpvpvpvLoLoLoLoLoLoLoLoLoLo
LoLoLoLoLoLoLoLoLoLopvpvpvpvpvpvpvpvpvpvpvpvZeZeZeZeZeZeXrXrXrXrXrXrZXZXZXZXZXZXZXZXXrZXZXZXZXXrZXXrZeZeZeZeZeZeZeZeZeZeZepvpvpvpvpvpvpvpvpvLoLoLoLoLoLoLoLoLoLo
LoLoLoLoLoLoLoLoLoLopvpvpvpvpvpvpvpvpvpvpvpvZeZeZeZeZeZeXrXrXrXrXrXrZXZXZXZXZXZXZXZXXrZXZXZXZXXrZXXrZeZeZeZeZeZeZeZeZeZeZepvpvpvpvpvpvpvpvpvLoLoLoLoLoLoLoLoLoLo
LoLoLoLoLoLoLoLoLoLopvpvpvpvpvpvpvpvpvpvpvpvZeZeZeZeZeZeXrXrXrXrXrXrZXZXZXZXZXZXZXZXXrZXZXZXZXXrZXXrZeZeZeZeZeZeZeZeZeZeZepvpvpvpvpvpvpvpvpvLoLoLoLoLoLoLoLoLoLo
LoLoLoLoLoLoLoLoLoLopvpvpvpvpvpvpvpvpvpvpvpvZeZeZeZeZeZeXrXrXrXrXrXrZXZXZXZXZXZXZXZXXrZXZXZXZXXrXrXrZeZeZeZeZeZeZeZeZeZeZepvpvpvpvpvpvpvpvpvLoLoLoLoLoLoLoLoLoLo
LoLoLoLoLoLoLoLoLoLopvpvpvpvpvpvpvpvpvpvpvpvZeZeZeZeZeZeXrXrXrXrXrXrZXZXZXZXZXZXZXZXXrZXZXZXZXZXZXXrZeZeZeZeZeZeZeZeZeZeZepvpvpvpvpvpvpvpvpvLoLoLoLoLoLoLoLoLoLo
LoLoLoLoLoLoLoLoLoLopvpvpvpvpvpvpvpvpvpvpvpvZeZeZeZeZeZeXrXrXrXrXrXrZXZXZXZXZXZXZXZXXrZXZXZXZXZXZXXrZeZeZeZeZeZeZeZeZeZeZepvpvpvpvpvpvpvpvpvLoLoLoLoLoLoLoLoLoLo
LoLoLoLoLoLoLoLoLoLopvpvpvpvpvpvpvpvpvpvpvpvZeZeZeZeZeZeXrXrXrXrXrXrZXZXZXZXZXZXZXZXXrZXZXZXZXZXZXXrZeZeZeZeZeZeZeZeZeZeZepvpvpvpvpvpvpvpvpvLoLoLoLoLoLoLoLoLoLo
LoLoLoLoLoLoLoLoLoLopvpvpvpvpvpvpvpvpvpvpvpvZeZeZeZeZeZeXrXrXrXrXrXrZXZXZXZXZXZXZXZXXrZXZXZXZXZXZXXrZeZeZeZeZeZeZeZeZeZeZepvpvpvpvpvpvpvpvpvLoLoLoLoLoLoLoLoLoLo
LoLoLoLoLoLoLoLoLoLopvpvpvpvpvpvpvpvpvpvpvpvZeZeZeZeZeZeXrXrXrXrXrXrZXZXZXZXZXZXZXZXXrZXZXZXZXZXZXXrZeZeZeZeZeZeZeZeZeZepvpvpvpvpvpvpvpvpvpvLoLoLoLoLoLoLoLoLoLo
LoLoLoLoLoLoLoLoLoLopvpvpvpvpvpvpvpvpvpvpvpvZeZeZeZeZeZeXrXrXrXrXrXrZXZXZXZXZXZXZXZXXrZXZXZXZXZXZXXrZeZeZeZeZeZeZeZeZeZepvpvpvpvpvpvpvpvpvpvLoLoLoLoLoLoLoLoLoLo
LoLoLoLoLoLoLoLoLoLopvpvpvpvpvpvpvpvpvpvpvpvZeZeZeZeZeZeXrXrXrXrXrXrZXZXZXZXXrXrXrXrXrXrXrZXZXZXZXXrZeZeZeZeZeZeZeZeZeZepvpvpvpvpvpvpvpvpvpvLoLoLoLoLoLoLoLoLoLo
LoLoLoLoLoLoLoLoLopvpvpvpvpvpvpvpvpvpvpvpvpvZeZeZeZeZeZeXrXrXrXrXrXrXrXrXrXrXrZXZXZXZXZXXrZXZXZXZXXrZeZeZeZeZeZeZeZeZeZepvpvpvpvpvpvpvpvpvpvpvLoLoLoLoLoLoLoLoLo
LoLoLoLoLoLoLoLoLopvpvpvpvpvpvpvpvpvpvpvpvpvZeZeZeZeZeZeXrXrXrXrXrXrZXZXZXZXXrZXZXZXZXZXXrZXZXZXZXXrZeZeZeZeZeZeZeZeZepvpvpvpvpvpvpvpvpvpvpvpvLoLoLoLoLoLoLoLoLo
LoLoLoLoLoLoLoLoLopvpvpvpvpvpvpvpvpvpvpvpvpvZeZeZeZeZeZeXrXrXrXrXrXrZXZXZXZXXrZXZXZXZXZXXrZXZXZXZXXrZeZeZeZeZeZeZeZeZepvpvpvpvpvpvpvpvpvpvpvpvLoLoLoLoLoLoLoLoLo
LoLoLoLoLoLoLoLoLopvpvpvpvpvpvpvpvpvpvpvpvpvZeZeZeZeZeZeXrXrXrXrXrXrZXZXZXZXXrXrXrXrXrXrXrZXZXZXZXXrZeZeZeZeZeZeZepvpvpvpvpvpvpvpvpvpvpvpvpvpvLoLoLoLoLoLoLoLoLo
LoLoLoLoLoLoLoLoLopvpvpvpvpvpvpvpvpvpvpvpvpvZeZeZeZeZeZeXrXrXrXrXrXrZXZXZXZXZXZXZXZXZXZXXrZXZXZXZXXrZeZeZeZeZeZeZepvpvpvpvpvpvpvpvpvpvpvpvpvpvLoLoLoLoLoLoLoLoLo
LoLoLoLoLoLoLoLoLopvpvpvpvpvpvpvpvpvpvpvpvpvZeZeZeZeZeZeXrXrXrXrXrXrZXZXZXZXZXZXZXZXZXZXXrZXZXZXZXXrZeZeZeZeZeZeZepvpvpvpvpvpvpvpvpvpvpvpvpvpvLoLoLoLoLoLoLoLoLo
LoLoLoLoLoLoLoLoLopvpvpvpvpvpvpvpvpvpvpvpvpvZeZeZeZeZeZeXrXrXrXrXrXrZXZXZXZXZXZXZXZXZXZXXrZXZXZXZXXrZeZeZeZeZeZeZepvpvpvpvpvpvpvpvpvpvpvpvpvpvLoLoLoLoLoLoLoLoLo
LoLoLoLoLoLoLoLoLopvpvpvpvpvpvpvpvpvpvpvpvpvZeZeZeZeZeZeXrXrXrXrXrXrZXZXZXZXZXZXZXZXZXZXXrZXZXZXZXXrZeZeZeZeZeZeZepvpvpvpvpvpvpvpvpvpvpvpvpvpvLoLoLoLoLoLoLoLoLo
LoLoLoLoLoLoLoLoLopvpvpvpvpvpvpvpvpvpvpvpvpvZeZeZeZeZeZeXrXrXrXrXrXrZXZXZXZXZXZXZXZXZXZXXrZXZXZXZXXrZeZeZeZeZeZeZepvpvpvpvpvpvpvpvpvpvpvpvpvpvLoLoLoLoLoLoLoLoLo
LoLoLoLoLoLoLoLoLoLopvpvpvpvpvpvpvpvpvpvpvpvZeZeZeZeZeZeXrXrXrXrXrXrZXZXZXZXZXZXZXZXZXZXXrZXZXZXZXXrZeZeZeZeZeZeZepvpvpvpvpvpvpvpvpvpvpvpvpvpvLoLoLoLoLoLoLoLoLo
LoLoLoLoLoLoLoLoLoLopvpvpvpvpvpvpvpvpvpvpvZeZeZeZeZeZeZeXrXrXrXrXrXrZXZXZXZXZXZXZXZXZXZXXrZXZXZXZXXrZeZeZeZeZeZeZepvpvpvpvpvpvpvpvpvpvpvpvpvpvLoLoLoLoLoLoLoLoLo
LoLoLoLoLoLoLoLoLoLopvpvpvpvpvpvpvpvpvpvpvZeZeZeZeZeZeZeXrXrXrXrXrXrZXZXZXZXZXZXZXZXZXZXXrZXZXZXZXXrZeZeZeZeZeZeZepvpvpvpvpvpvpvpvpvpvpvpvpvpvLoLoLoLoLoLoLoLoLo
LoLoLoLoLoLoLoLoLoLopvpvpvpvpvpvpvpvpvpvpvZeZeZeZeZeZeZeXrXrXrXrXrXrZXZXZXZXZXZXZXZXZXZXXrZXZXZXZXXrZeZeZeZeZeZeZepvpvpvpvpvpvpvpvpvpvpvpvpvpvLoLoLoLoLoLoLoLoLo
LoLoLoLoLoLoLoLoLoLopvpvpvpvpvpvpvpvpvpvZeZeZeZeZeZeZeZeXrXrXrXrXrXrZXZXZXZXZXZXZXZXZXZXXrZXZXZXZXXrZeZeZeZeZeZeZepvpvpvpvpvpvpvpvpvpvpvpvpvpvLoLoLoLoLoLoLoLoLo
LoLoLoLoLoLoLoLoLoLopvpvpvpvpvpvpvpvpvZeZeZeZeZeZeZeZeZeXrXrXrXrXrXrZXZXZXZXZXZXZXZXZXZXXrZXZXZXZXXrZeZeZeZeZeZeZepvpvpvpvpvpvpvpvpvpvpvpvpvpvLoLoLoLoLoLoLoLoLo
LoLoLoLoLoLoLoLoLoLoLopvpvpvpvpvpvpvpvZeZeZeZeZeZeZeZeZeXrXrXrXrXrXrZXZXZXZXZXZXZXZXZXZXXrZXZXZXZXXrZeZeZeZeZeZeZepvpvpvpvpvpvpvpvpvpvpvpvpvLoLoLoLoLoLoLoLoLoLo
LoLoLoLoLoLoLoLoLoLoLopvpvpvpvpvpvpvZeZeZeZeZeZeZeZeZeZeXrXrXrXrXrXrZXZXZXZXZXZXZXZXZXZXXrZXZXZXZXXrZeZeZeZeZeZeZepvpvpvpvpvpvpvpvpvpvpvpvpvLoLoLoLoLoLoLoLoLoLo
LoLoLoLoLoLoLoLoLoLoLopvpvpvpvpvpvpvZeZeZeZeZeZeZeZeZeZeXrXrXrXrXrXrXrXrXrXrXrXrXrXrXrXrXrXrXrXrXrXrZeZeZeZeZeZeZepvpvpvpvpvpvpvpvpvpvpvpvpvLoLoLoLoLoLoLoLoLoLo
LoLoLoLoLoLoLoLoLoLoLopvpvpvpvpvpvpvZeZeZeZeZeZeZeZeZeZeXrXrXrXrXrXrXrXrXrXrXrXrXrXrXrXrXrXrXrXrXrXrZeZeZeZeZeZeZepvpvpvpvpvpvpvpvpvpvpvpvpvLoLoLoLoLoLoLoLoLoLo
LoLoLoLoLoLoLoLoLoLoLopvpvpvpvpvpvpvZeZeZeZeZeZeZeZeZeZeZeZeZeZeZeZeZeZeZeZeZeZeZeZeZeZeZeZeZeZeZeZeZeZeZeZeZeZeZepvpvpvpvpvpvpvpvpvpvpvpvpvLoLoLoLoLoLoLoLoLoLo
LoLoLoLoLoLoLoLoLoLoLopvpvpvpvpvpvpvZeZeZeZeZeZeZeZeZeZeZeZeZeZeZeZeZeZeZeZeZeZeZeZeZeZeZeZeZeZeZeZeZeZeZeZeZeZeZepvpvpvpvpvpvpvpvpvpvpvpvpvLoLoLoLoLoLoLoLoLoLo
LoLoLoLoLoLoLoLoLoLoLopvpvpvpvpvpvpvpvpvpvZeZeZeZeZeZeZeZeZeZeZeZeZeZeZeZeZeZeZeZeZeZeZeZeZeZeZeZeZeZeZeZeZeZepvpvpvpvpvpvpvpvpvpvpvpvpvpvpvLoLoLoLoLoLoLoLoLoLo
LoLoLoLoLoLoLoLoLoLoLoLoLopvpvpvpvpvpvpvpvpvpvpvpvpvpvpvpvpvpvpvpvpvpvpvpvpvpvpvpvpvpvpvpvpvpvpvpvpvpvpvpvpvpvpvpvpvpvpvpvpvpvpvpvpvpvpvLoLoLoLoLoLoLoLoLoLoLoLo
LoLoLoLoLoLoLoLoLoLoLoLoLoLoLoLoLoLoLoLoLoLoLoLoLoLoLoLoLoLoLoLoLoLoLoLoLoLoLoLoLoLoLoLoLoLoLoLoLoLoLoLoLoLoLoLoLoLoLoLoLoLoLoLoLoLoLoLoLoLoLoLoLoLoLoLoLoLoLoLo
LodQLojSLoLoLoLoLoLoLoLoLoLoLoLoLoLoLoLoLoLoLoLoLoLoLoLoLoLoLoLoLoLoLoLoLoLoLoLoLoLoLoLoLoLoLoLoLoLoLoLoLoLoLoLoLoLoLoLoLoLoLoLoLoLoLoLoLoLoLoLoLoLoLoLoLoLoLoLo
LoLoLoLoLoLoLoLoLoLoLoLoLoLoLoLoLoLoLoLoLoLoLoLoLoLoLoLoLoLoLoLoLoLoLoLoLoLoLoLoLoLoLoLoLoLoLoLoLoLoLoLoLoLoLoLoLoLoLoLoLoLoLoLoLoLoLoLoLoLoLoLoLoLoLoLoLoLoLoLo
"}
