"aa" = (/turf/space,/area/space)
"ZC" = (/turf/simulated/open,/area/space)
"ZL" = (/turf/simulated/wall/r_wall/prepainted,/area/space)
"ZZ" = (/turf/simulated/floor/plating,/area/space)

(1,1,1) = {"
aaaaaaaaaaaaaaaaaaaaaaaaaaaaaaaaaaaaaaaaaaaaaaaaaaaaaaaaaaaaaaaaaaaaaaaaaaaaaaaaaaaaaaaaaaaaaaaaaaaaaaaaaaaaaaaaaaaaaaaaaaaaaaaaaaaaaaaaaaaaaaaaaaaaaaaaaaaaaaaa
aaaaaaaaaaaaaaaaaaaaaaaaaaaaaaaaaaaaaaaaaaaaaaaaaaaaaaaaaaaaaaaaaaaaaaaaaaaaaaaaaaaaaaaaaaaaaaaaaaaaaaaaaaaaaaaaaaaaaaaaaaaaaaaaaaaaaaaaaaaaaaaaaaaaaaaaaaaaaaaa
aaaaaaaaaaaaaaaaaaaaaaaaaaaaaaZLZLZLZLZLZLZLZLZLZLZLZLZLZLZLZLZLZLZLZLZLZLZLZLZLZLZLZLZLZLZLZLZLZLZLZLZLZLZLZLZLZLZLZLZLZLZLZLZLZLaaaaaaaaaaaaaaaaaaaaaaaaaaaaaa
aaaaaaaaaaaaaaaaaaaaaaaaaaaaaaZLZLZLZLZLZLZLZLZLZLZLZLZLZLZLZLZLZLZLZLZLZLZLZLZLZLZLZLZLZLZLZLZLZLZLZLZLZLZLZLZLZLZLZLZLZLZLZLZLZLaaaaaaaaaaaaaaaaaaaaaaaaaaaaaa
aaaaaaaaaaaaaaaaaaaaZLZLZLZLZLZLZLZLZLZLZLZLZLZLZLZLZLZLZLZLZLZLZLZLZLZLZLZLZLZLZLZLZLZLZLZLZLZLZLZLZLZLZLZLZLZLZLZLZLZLZLZLZLZLZLZLZLZLZLZLaaaaaaaaaaaaaaaaaaaa
aaaaaaaaaaaaaaaaaaaaZLZLZLZLZLZLZLZLZLZLZLZLZLZLZLZLZLZLZLZLZLZLZLZLZLZLZLZLZLZLZLZLZLZLZLZLZLZLZLZLZLZLZLZLZLZLZLZLZLZLZLZLZLZLZLZLZLZLZLZLaaaaaaaaaaaaaaaaaaaa
aaaaaaaaaaaaaaaaaaaaZLZLZLZLZLZLZLZLZLZLZLZLZLZLZLZLZLZLZLZLZLZLZLZLZLZLZLZLZLZLZLZLZLZLZLZLZLZLZLZLZLZLZLZLZLZLZLZLZLZLZLZLZLZLZLZLZLZLZLZLaaaaaaaaaaaaaaaaaaaa
aaaaaaaaaaaaaaaaaaaaZLZLZLZLZLZLZLZLZLZLZLZLZLZLZLZLZLZLZLZLZLZLZLZLZLZLZLZLZLZLZLZLZLZLZLZLZLZLZLZLZLZLZLZLZLZLZLZLZLZLZLZLZLZLZLZLZLZLZLZLaaaaaaaaaaaaaaaaaaaa
aaaaaaaaaaaaaaaaaaaaZLZLZLZLZLZLZLZLZLZLZLZLZLZLZLZLZLZLZLZLZLZLZLZLZCZCZCZCZCZCZCZCZCZCZCZCZCZCZCZLZLZLZLZLZLZLZLZLZLZLZLZLZLZLZLZLZLZLZLZLaaaaaaaaaaaaaaaaaaaa
aaaaaaaaaaaaaaaaaaaaZLZLZLZLZLZLZLZLZZZZZZZZZZZZZZZZZZZZZZZZZZZZZZZZZCZCZCZCZCZCZCZCZCZCZCZCZCZCZCZZZZZZZZZZZZZZZZZZZZZZZLZLZLZLZLZLZLZLZLZLaaaaaaaaaaaaaaaaaaaa
aaaaaaaaaaaaaaaaaaaaZLZLZLZLZLZLZLZLZZZZZZZZZZZZZZZZZZZZZZZZZZZZZZZZZCZCZCZCZCZCZCZCZCZCZCZCZCZCZCZZZZZZZZZZZZZZZZZZZZZZZLZLZLZLZLZLZLZLZLZLaaaaaaaaaaaaaaaaaaaa
aaaaaaaaaaaaaaaaaaaaZLZLZLZLZLZLZLZLZZZZZZZZZZZZZZZZZZZZZZZZZZZZZZZZZCZCZCZCZCZCZCZCZCZCZCZCZCZCZCZZZZZZZZZZZZZZZZZZZZZZZLZLZLZLZLZLZLZLZLZLaaaaaaaaaaaaaaaaaaaa
aaaaaaaaaaaaaaaaaaaaZLZLZLZLZLZLZLZLZZZZZZZZZZZZZZZZZZZZZZZZZZZZZZZZZCZCZCZCZCZCZCZCZCZCZCZCZCZCZCZZZZZZZZZZZZZZZZZZZZZZZLZLZLZLZLZLZLZLZLZLaaaaaaaaaaaaaaaaaaaa
aaaaaaaaaaaaaaaaaaaaZLZLZLZLZLZLZLZLZZZZZZZZZZZZZZZZZZZZZZZZZZZZZZZZZCZCZCZCZCZCZCZCZCZCZCZCZCZCZCZZZZZZZZZZZZZZZZZZZZZZZLZLZLZLZLZLZLZLZLZLaaaaaaaaaaaaaaaaaaaa
aaaaaaaaaaaaaaaaaaaaZLZLZLZLZLZLZLZLZZZZZZZZZZZZZZZZZZZZZZZZZZZZZZZZZCZCZCZCZCZCZCZCZCZCZCZCZCZCZCZZZZZZZZZZZZZZZZZZZZZZZLZLZLZLZLZLZLZLZLZLaaaaaaaaaaaaaaaaaaaa
aaaaaaaaaaaaaaaaaaaaZLZLZLZLZLZLZLZLZZZZZZZZZZZZZZZZZZZZZZZZZZZZZZZZZCZCZCZCZCZCZCZCZCZCZCZCZCZCZCZZZZZZZZZZZZZZZZZZZZZZZLZLZLZLZLZLZLZLZLZLaaaaaaaaaaaaaaaaaaaa
aaaaaaaaaaaaaaaaaaaaZLZLZLZLZLZLZLZLZZZZZZZZZZZZZZZZZZZZZZZZZZZZZZZZZCZCZCZCZCZCZCZCZCZCZCZCZCZCZCZZZZZZZZZZZZZZZZZZZZZZZLZLZLZLZLZLZLZLZLZLaaaaaaaaaaaaaaaaaaaa
aaaaaaaaaaaaaaaaaaaaZLZLZLZLZLZLZLZLZZZZZZZZZZZZZZZZZZZZZZZZZZZZZZZZZCZCZCZCZCZCZCZCZCZCZCZCZCZCZCZZZZZZZZZZZZZZZZZZZZZZZLZLZLZLZLZLZLZLZLZLaaaaaaaaaaaaaaaaaaaa
aaaaaaaaaaaaaaaaaaaaZLZLZLZLZLZLZLZLZZZZZZZZZZZZZZZZZZZZZZZZZZZZZZZZZCZCZCZCZCZCZCZCZCZCZCZCZCZCZCZZZZZZZZZZZZZZZZZZZZZZZLZLZLZLZLZLZLZLZLZLaaaaaaaaaaaaaaaaaaaa
aaaaaaaaaaaaaaaaaaaaZLZLZLZLZLZLZLZLZZZZZZZZZZZZZZZZZZZZZZZZZZZZZZZZZCZCZCZCZCZCZCZCZCZCZCZCZCZCZCZZZZZZZZZZZZZZZZZZZZZZZLZLZLZLZLZLZLZLZLZLaaaaaaaaaaaaaaaaaaaa
aaaaaaaaaaaaaaaaaaaaZLZLZLZLZLZLZLZLZZZZZZZZZZZZZZZZZZZZZZZZZZZZZZZZZCZCZCZCZCZCZCZCZCZCZCZCZCZCZCZZZZZZZZZZZZZZZZZZZZZZZLZLZLZLZLZLZLZLZLZLaaaaaaaaaaaaaaaaaaaa
aaaaaaaaaaaaaaaaaaaaZLZLZLZLZLZLZLZLZZZZZZZZZZZZZZZZZZZZZZZZZZZZZZZZZCZCZCZCZCZCZCZCZCZCZCZCZCZCZCZZZZZZZZZZZZZZZZZZZZZZZLZLZLZLZLZLZLZLZLZLaaaaaaaaaaaaaaaaaaaa
aaaaaaaaaaaaaaaaaaaaZLZLZLZLZLZLZLZLZZZZZZZZZZZZZZZZZZZZZZZZZZZZZZZZZCZCZCZCZCZCZCZCZCZCZCZCZCZCZCZZZZZZZZZZZZZZZZZZZZZZZLZLZLZLZLZLZLZLZLZLaaaaaaaaaaaaaaaaaaaa
aaaaaaaaaaaaaaaaaaaaZLZLZLZLZLZLZLZLZZZZZZZZZZZZZZZZZZZZZZZZZZZZZZZZZCZCZCZCZCZCZCZCZCZCZCZCZCZCZCZZZZZZZZZZZZZZZZZZZZZZZLZLZLZLZLZLZLZLZLZLaaaaaaaaaaaaaaaaaaaa
aaaaaaaaaaaaaaaaaaaaZLZLZLZLZLZLZLZLZZZZZZZZZZZZZZZZZZZZZZZZZZZZZZZZZCZCZCZCZCZCZCZCZCZCZCZCZCZCZCZZZZZZZZZZZZZZZZZZZZZZZLZLZLZLZLZLZLZLZLZLaaaaaaaaaaaaaaaaaaaa
aaaaaaaaaaaaaaaaaaaaZLZLZLZLZLZLZLZLZZZZZZZZZZZZZZZZZZZZZZZZZZZZZZZZZCZCZCZCZCZCZCZCZCZCZCZCZCZCZCZZZZZZZZZZZZZZZZZZZZZZZLZLZLZLZLZLZLZLZLZLaaaaaaaaaaaaaaaaaaaa
aaaaaaaaaaaaaaaaaaaaZLZLZLZLZLZLZLZLZZZZZZZZZZZZZZZZZZZZZZZZZZZZZZZZZCZCZCZCZCZCZCZCZCZCZCZCZCZCZCZZZZZZZZZZZZZZZZZZZZZZZLZLZLZLZLZLZLZLZLZLaaaaaaaaaaaaaaaaaaaa
aaaaaaaaaaaaaaaaaaaaZLZLZLZLZLZLZLZLZZZZZZZZZZZZZZZZZZZZZZZZZZZZZZZZZCZCZCZCZCZCZCZCZCZCZCZCZCZCZCZZZZZZZZZZZZZZZZZZZZZZZLZLZLZLZLZLZLZLZLZLaaaaaaaaaaaaaaaaaaaa
aaaaaaaaaaaaaaaaaaaaZLZLZLZLZLZLZLZLZZZZZZZZZZZZZZZZZZZZZZZZZZZZZZZZZCZCZCZCZCZCZCZCZCZCZCZCZCZCZCZZZZZZZZZZZZZZZZZZZZZZZLZLZLZLZLZLZLZLZLZLaaaaaaaaaaaaaaaaaaaa
aaaaaaaaaaaaaaaaaaaaZLZLZLZLZLZLZLZLZZZZZZZZZZZZZZZZZZZZZZZZZZZZZZZZZCZCZCZCZCZCZCZCZCZCZCZCZCZCZCZZZZZZZZZZZZZZZZZZZZZZZLZLZLZLZLZLZLZLZLZLaaaaaaaaaaaaaaaaaaaa
aaaaaaaaaaaaaaaaaaaaZLZLZLZLZLZLZLZLZZZZZZZZZZZZZZZZZZZZZZZZZZZZZZZZZCZCZCZCZCZCZCZCZCZCZCZCZCZCZCZZZZZZZZZZZZZZZZZZZZZZZLZLZLZLZLZLZLZLZLZLaaaaaaaaaaaaaaaaaaaa
aaaaaaaaaaaaaaaaaaaaZLZLZLZLZLZLZLZLZZZZZZZZZZZZZZZZZZZZZZZZZZZZZZZZZCZCZCZCZCZCZCZCZCZCZCZCZCZCZCZZZZZZZZZZZZZZZZZZZZZZZLZLZLZLZLZLZLZLZLZLaaaaaaaaaaaaaaaaaaaa
aaaaaaaaaaaaaaaaaaaaZLZLZLZLZLZLZLZLZZZZZZZZZZZZZZZZZZZZZZZZZZZZZZZZZCZCZCZCZCZCZCZCZCZCZCZCZCZCZCZZZZZZZZZZZZZZZZZZZZZZZLZLZLZLZLZLZLZLZLZLaaaaaaaaaaaaaaaaaaaa
aaaaaaaaaaaaaaaaaaaaZLZLZLZLZLZLZLZLZZZZZZZZZZZZZZZZZZZZZZZZZZZZZZZZZCZCZCZCZCZCZCZCZCZCZCZCZCZCZCZZZZZZZZZZZZZZZZZZZZZZZLZLZLZLZLZLZLZLZLZLaaaaaaaaaaaaaaaaaaaa
aaaaaaaaaaaaaaaaaaaaZLZLZLZLZLZLZLZLZZZZZZZZZZZZZZZZZZZZZZZZZZZZZZZZZCZCZCZCZCZCZCZCZCZCZCZCZCZCZCZZZZZZZZZZZZZZZZZZZZZZZLZLZLZLZLZLZLZLZLZLaaaaaaaaaaaaaaaaaaaa
aaaaaaaaaaaaaaaaaaaaZLZLZLZLZLZLZLZLZZZZZZZZZZZZZZZZZZZZZZZZZZZZZZZZZCZCZCZCZCZCZCZCZCZCZCZCZCZCZCZZZZZZZZZZZZZZZZZZZZZZZLZLZLZLZLZLZLZLZLZLaaaaaaaaaaaaaaaaaaaa
aaaaaaaaaaaaaaaaaaaaZLZLZLZLZLZLZLZLZZZZZZZZZZZZZZZZZZZZZZZZZZZZZZZZZCZCZCZCZCZCZCZCZCZCZCZCZCZCZCZZZZZZZZZZZZZZZZZZZZZZZLZLZLZLZLZLZLZLZLZLaaaaaaaaaaaaaaaaaaaa
aaaaaaaaaaaaaaaaaaaaZLZLZLZLZLZLZLZLZZZZZZZZZZZZZZZZZZZZZZZZZZZZZZZZZCZCZCZCZCZCZCZCZCZCZCZCZCZCZCZZZZZZZZZZZZZZZZZZZZZZZLZLZLZLZLZLZLZLZLZLaaaaaaaaaaaaaaaaaaaa
aaaaaaaaaaaaaaaaaaaaZLZLZLZLZLZLZLZLZZZZZZZZZZZZZZZZZZZZZZZZZZZZZZZZZCZCZCZCZCZCZCZCZCZCZCZCZCZCZCZZZZZZZZZZZZZZZZZZZZZZZLZLZLZLZLZLZLZLZLZLaaaaaaaaaaaaaaaaaaaa
aaaaaaaaaaaaaaaaaaaaZLZLZLZLZLZLZLZLZZZZZZZZZZZZZZZZZZZZZZZZZZZZZZZZZCZCZCZCZCZCZCZCZCZCZCZCZCZCZCZZZZZZZZZZZZZZZZZZZZZZZLZLZLZLZLZLZLZLZLZLaaaaaaaaaaaaaaaaaaaa
aaaaaaaaaaaaaaaaaaaaZLZLZLZLZLZLZLZLZZZZZZZZZZZZZZZZZZZZZZZZZZZZZZZZZCZCZCZCZCZCZCZCZCZCZCZCZCZCZCZZZZZZZZZZZZZZZZZZZZZZZLZLZLZLZLZLZLZLZLZLaaaaaaaaaaaaaaaaaaaa
aaaaaaaaaaaaaaaaaaaaZLZLZLZLZLZLZLZLZZZZZZZZZZZZZZZZZZZZZZZZZZZZZZZZZCZCZCZCZCZCZCZCZCZCZCZCZCZCZCZZZZZZZZZZZZZZZZZZZZZZZLZLZLZLZLZLZLZLZLZLaaaaaaaaaaaaaaaaaaaa
aaaaaaaaaaaaaaaaaaaaZLZLZLZLZLZLZLZLZZZZZZZZZZZZZZZZZZZZZZZZZZZZZZZZZCZCZCZCZCZCZCZCZCZCZCZCZCZCZCZZZZZZZZZZZZZZZZZZZZZZZLZLZLZLZLZLZLZLZLZLaaaaaaaaaaaaaaaaaaaa
aaaaaaaaaaaaaaaaaaaaZLZLZLZLZLZLZLZLZZZZZZZZZZZZZZZZZZZZZZZZZZZZZZZZZCZCZCZCZCZCZCZCZCZCZCZCZCZCZCZZZZZZZZZZZZZZZZZZZZZZZLZLZLZLZLZLZLZLZLZLaaaaaaaaaaaaaaaaaaaa
aaaaaaaaaaaaaaaaaaaaZLZLZLZLZLZLZLZLZZZZZZZZZZZZZZZZZZZZZZZZZZZZZZZZZCZCZCZCZCZCZCZCZCZCZCZCZCZCZCZZZZZZZZZZZZZZZZZZZZZZZLZLZLZLZLZLZLZLZLZLaaaaaaaaaaaaaaaaaaaa
aaaaaaaaaaaaaaaaaaaaZLZLZLZLZLZLZLZLZZZZZZZZZZZZZZZZZZZZZZZZZZZZZZZZZCZCZCZCZCZCZCZCZCZCZCZCZCZCZCZZZZZZZZZZZZZZZZZZZZZZZLZLZLZLZLZLZLZLZLZLaaaaaaaaaaaaaaaaaaaa
aaaaaaaaaaaaaaaaaaaaZLZLZLZLZLZLZLZLZZZZZZZZZZZZZZZZZZZZZZZZZZZZZZZZZCZCZCZCZCZCZCZCZCZCZCZCZCZCZCZZZZZZZZZZZZZZZZZZZZZZZLZLZLZLZLZLZLZLZLZLaaaaaaaaaaaaaaaaaaaa
aaaaaaaaaaaaaaaaaaaaZLZLZLZLZLZLZLZLZZZZZZZZZZZZZZZZZZZZZZZZZZZZZZZZZCZCZCZCZCZCZCZCZCZCZCZCZCZCZCZZZZZZZZZZZZZZZZZZZZZZZLZLZLZLZLZLZLZLZLZLaaaaaaaaaaaaaaaaaaaa
aaaaaaaaaaaaaaaaaaaaZLZLZLZLZLZLZLZLZZZZZZZZZZZZZZZZZZZZZZZZZZZZZZZZZCZCZCZCZCZCZCZCZCZCZCZCZCZCZCZZZZZZZZZZZZZZZZZZZZZZZLZLZLZLZLZLZLZLZLZLaaaaaaaaaaaaaaaaaaaa
aaaaaaaaaaaaaaaaaaaaZLZLZLZLZLZLZLZLZZZZZZZZZZZZZZZZZZZZZZZZZZZZZZZZZCZCZCZCZCZCZCZCZCZCZCZCZCZCZCZZZZZZZZZZZZZZZZZZZZZZZLZLZLZLZLZLZLZLZLZLaaaaaaaaaaaaaaaaaaaa
aaaaaaaaaaaaaaaaaaaaZLZLZLZLZLZLZLZLZZZZZZZZZZZZZZZZZZZZZZZZZZZZZZZZZCZCZCZCZCZCZCZCZCZCZCZCZCZCZCZZZZZZZZZZZZZZZZZZZZZZZLZLZLZLZLZLZLZLZLZLaaaaaaaaaaaaaaaaaaaa
aaaaaaaaaaaaaaaaaaaaZLZLZLZLZLZLZLZLZZZZZZZZZZZZZZZZZZZZZZZZZZZZZZZZZCZCZCZCZCZCZCZCZCZCZCZCZCZCZCZZZZZZZZZZZZZZZZZZZZZZZLZLZLZLZLZLZLZLZLZLaaaaaaaaaaaaaaaaaaaa
aaaaaaaaaaaaaaaaaaaaZLZLZLZLZLZLZLZLZZZZZZZZZZZZZZZZZZZZZZZZZZZZZZZZZCZCZCZCZZZZZZZZZZZZZZZCZCZCZCZZZZZZZZZZZZZZZZZZZZZZZLZLZLZLZLZLZLZLZLZLaaaaaaaaaaaaaaaaaaaa
aaaaaaaaaaaaaaaaaaaaZLZLZLZLZLZLZLZLZZZZZZZZZZZZZZZZZZZZZZZZZZZZZZZZZCZCZCZZZZZZZZZZZZZZZZZZZCZCZCZZZZZZZZZZZZZZZZZZZZZZZLZLZLZLZLZLZLZLZLZLaaaaaaaaaaaaaaaaaaaa
aaaaaaaaaaaaaaaaaaZLZLZLZLZLZLZLZLZLZZZZZZZZZZZZZZZZZZZZZZZZZZZZZZZZZZZZZZZZZZZCZCZCZCZCZZZZZZZZZZZZZZZZZZZZZZZZZZZZZZZZZLZLZLZLZLZLZLZLZLZLZLaaaaaaaaaaaaaaaaaa
aaaaaaaaaaaaaaaaaaZLZLZLZLZLZLZLZLZLZZZZZZZZZZZZZZZZZZZZZZZZZZZZZZZZZZZZZZZZZZZCZCZCZCZCZZZZZZZZZZZZZZZZZZZZZZZZZZZZZZZZZLZLZLZLZLZLZLZLZLZLZLaaaaaaaaaaaaaaaaaa
aaaaaaaaaaaaaaaaaaZLZLZLZLZLZLZLZLZLZZZZZZZZZZZZZZZZZZZZZZZZZZZZZZZZZZZZZZZZZZZCZCZCZCZCZZZZZZZZZZZZZZZZZZZZZZZZZZZZZZZZZLZLZLZLZLZLZLZLZLZLZLaaaaaaaaaaaaaaaaaa
aaaaaaaaaaaaaaaaaaZLZLZLZLZLZLZLZLZLZZZZZZZZZZZZZZZZZZZZZZZZZZZZZZZZZCZCZCZZZZZZZZZZZZZZZZZZZCZCZCZZZZZZZZZZZZZZZZZZZZZZZLZLZLZLZLZLZLZLZLZLZLaaaaaaaaaaaaaaaaaa
aaaaaaaaaaaaaaaaaaZLZLZLZLZLZLZLZLZLZZZZZZZZZZZZZZZZZZZZZZZZZZZZZZZZZCZCZCZCZZZZZZZZZZZZZZZCZCZCZCZZZZZZZZZZZZZZZZZZZZZZZLZLZLZLZLZLZLZLZLZLZLaaaaaaaaaaaaaaaaaa
aaaaaaaaaaaaaaaaaaZLZLZLZLZLZLZLZLZLZZZZZZZZZZZZZZZZZZZZZZZZZZZZZZZZZCZCZCZCZCZCZCZCZCZCZCZCZCZCZCZZZZZZZZZZZZZZZZZZZZZZZLZLZLZLZLZLZLZLZLZLZLaaaaaaaaaaaaaaaaaa
aaaaaaaaaaaaaaaaaaZLZLZLZLZLZLZLZLZLZZZZZZZZZZZZZZZZZZZZZZZZZZZZZZZZZCZCZCZCZCZCZCZCZCZCZCZCZCZCZCZZZZZZZZZZZZZZZZZZZZZZZLZLZLZLZLZLZLZLZLZLZLaaaaaaaaaaaaaaaaaa
aaaaaaaaaaaaaaaaaaZLZLZLZLZLZLZLZLZLZZZZZZZZZZZZZZZZZZZZZZZZZZZZZZZZZCZCZCZCZCZCZCZCZCZCZCZCZCZCZCZZZZZZZZZZZZZZZZZZZZZZZLZLZLZLZLZLZLZLZLZLZLaaaaaaaaaaaaaaaaaa
aaaaaaaaaaaaaaaaaaZLZLZLZLZLZLZLZLZLZZZZZZZZZZZZZZZZZZZZZZZZZZZZZZZZZCZCZCZCZCZCZCZCZCZCZCZCZCZCZCZZZZZZZZZZZZZZZZZZZZZZZLZLZLZLZLZLZLZLZLZLZLaaaaaaaaaaaaaaaaaa
aaaaaaaaaaaaaaaaaaaaZLZLZLZLZLZLZLZLZZZZZZZZZZZZZZZZZZZZZZZZZZZZZZZZZCZCZCZCZCZCZCZCZCZCZCZCZCZCZCZZZZZZZZZZZZZZZZZZZZZZZLZLZLZLZLZLZLZLZLZLZLaaaaaaaaaaaaaaaaaa
aaaaaaaaaaaaaaaaaaaaZLZLZLZLZLZLZLZLZZZZZZZZZZZZZZZZZZZZZZZZZZZZZZZZZCZCZCZCZCZCZCZCZCZCZCZCZCZCZCZZZZZZZZZZZZZZZZZZZZZZZLZLZLZLZLZLZLZLZLZLZLaaaaaaaaaaaaaaaaaa
aaaaaaaaaaaaaaaaaaaaZLZLZLZLZLZLZLZLZZZZZZZZZZZZZZZZZZZZZZZZZZZZZZZZZCZCZCZCZCZCZCZCZCZCZCZCZCZCZCZZZZZZZZZZZZZZZZZZZZZZZLZLZLZLZLZLZLZLZLZLZLaaaaaaaaaaaaaaaaaa
aaaaaaaaaaaaaaaaaaaaZLZLZLZLZLZLZLZLZZZZZZZZZZZZZZZZZZZZZZZZZZZZZZZZZCZCZCZCZCZCZCZCZCZCZCZCZCZCZCZZZZZZZZZZZZZZZZZZZZZZZLZLZLZLZLZLZLZLZLZLZLaaaaaaaaaaaaaaaaaa
aaaaaaaaaaaaaaaaaaaaZLZLZLZLZLZLZLZLZZZZZZZZZZZZZZZZZZZZZZZZZZZZZZZZZCZCZCZCZCZCZCZCZCZCZCZCZCZCZCZZZZZZZZZZZZZZZZZZZZZZZLZLZLZLZLZLZLZLZLZLZLaaaaaaaaaaaaaaaaaa
aaaaaaaaaaaaaaaaaaaaZLZLZLZLZLZLZLZLZZZZZZZZZZZZZZZZZZZZZZZZZZZZZZZZZCZCZCZCZCZCZCZCZCZCZCZCZCZCZCZZZZZZZZZZZZZZZZZZZZZZZLZLZLZLZLZLZLZLZLZLZLaaaaaaaaaaaaaaaaaa
aaaaaaaaaaaaaaaaaaaaZLZLZLZLZLZLZLZLZZZZZZZZZZZZZZZZZZZZZZZZZZZZZZZZZCZCZCZCZCZCZCZCZCZCZCZCZCZCZCZZZZZZZZZZZZZZZZZZZZZZZLZLZLZLZLZLZLZLZLZLaaaaaaaaaaaaaaaaaaaa
aaaaaaaaaaaaaaaaaaaaZLZLZLZLZLZLZLZLZZZZZZZZZZZZZZZZZZZZZZZZZZZZZZZZZCZCZCZCZCZCZCZCZCZCZCZCZCZCZCZZZZZZZZZZZZZZZZZZZZZZZLZLZLZLZLZLZLZLZLZLaaaaaaaaaaaaaaaaaaaa
aaaaaaaaaaaaaaaaaaaaZLZLZLZLZLZLZLZLZLZLZLZLZLZLZLZLZLZLZLZLZLZLZLZLZLZLZLZLZLZLZLZLZLZLZLZLZLZLZLZLZLZLZLZLZLZLZLZLZLZLZLZLZLZLZLZLZLZLZLZLaaaaaaaaaaaaaaaaaaaa
aaaaaaaaaaaaaaaaaaaaZLZLZLZLZLZLZLZLZLZLZLZLZLZLZLZLZLZLZLZLZLZLZLZLZLZLZLZLZLZLZLZLZLZLZLZLZLZLZLZLZLZLZLZLZLZLZLZLZLZLZLZLZLZLZLZLZLZLZLZLaaaaaaaaaaaaaaaaaaaa
aaaaaaaaaaaaaaaaaaaaZLZLZLZLZLZLZLZLZLZLZLZLZLZLZLZLZLZLZLZLZLZLZLZLZLZLZLZLZLZLZLZLZLZLZLZLZLZLZLZLZLZLZLZLZLZLZLZLZLZLZLZLZLZLZLZLZLZLZLZLaaaaaaaaaaaaaaaaaaaa
aaaaaaaaaaaaaaaaaaaaZLZLZLZLZLZLZLZLZLZLZLZLZLZLZLZLZLZLZLZLZLZLZLZLZLZLZLZLZLZLZLZLZLZLZLZLZLZLZLZLZLZLZLZLZLZLZLZLZLZLZLZLZLZLZLZLZLZLZLZLaaaaaaaaaaaaaaaaaaaa
aaaaaaaaaaaaaaaaaaaaZLZLZLZLZLZLZLZLZLZLZLZLZLZLZLZLZLZLZLZLZLZLZLZLZLZLZLZLZLZLZLZLZLZLZLZLZLZLZLZLZLZLZLZLZLZLZLZLZLZLZLZLZLZLZLZLZLZLZLZLaaaaaaaaaaaaaaaaaaaa
aaaaaaaaaaaaaaaaaaaaaaaaaaZLZLZLZLZLZLZLZLZLZLZLZLZLZLZLZLZLZLZLZLZLZLZLZLZLZLZLZLZLZLZLZLZLZLZLZLZLZLZLZLZLZLZLZLZLZLZLZLZLZLZLZLZLZLZLaaaaaaaaaaaaaaaaaaaaaaaa
aaaaaaaaaaaaaaaaaaaaaaaaaaaaaaaaaaaaaaaaaaaaaaaaaaaaaaaaaaaaaaaaaaaaaaaaaaaaaaaaaaaaaaaaaaaaaaaaaaaaaaaaaaaaaaaaaaaaaaaaaaaaaaaaaaaaaaaaaaaaaaaaaaaaaaaaaaaaaaaa
aaaaaaaaaaaaaaaaaaaaaaaaaaaaaaaaaaaaaaaaaaaaaaaaaaaaaaaaaaaaaaaaaaaaaaaaaaaaaaaaaaaaaaaaaaaaaaaaaaaaaaaaaaaaaaaaaaaaaaaaaaaaaaaaaaaaaaaaaaaaaaaaaaaaaaaaaaaaaaaa
aaaaaaaaaaaaaaaaaaaaaaaaaaaaaaaaaaaaaaaaaaaaaaaaaaaaaaaaaaaaaaaaaaaaaaaaaaaaaaaaaaaaaaaaaaaaaaaaaaaaaaaaaaaaaaaaaaaaaaaaaaaaaaaaaaaaaaaaaaaaaaaaaaaaaaaaaaaaaaaa
"}
