"aa" = (/turf/space,/area/space)
"ab" = (/obj/effect/landmark/test/space_turf,/turf/space,/area/space)
"ac" = (/obj/effect/landmark/map_data{height = 2},/turf/space,/area/space)
"ad" = (/turf/simulated/wall/r_wall/prepainted,/area/space)
"aT" = (/obj/structure/railing/mapped{dir = 8},/obj/structure/railing/mapped{dir = 1},/obj/structure/ladder,/turf/simulated/floor/plating,/area/space)
"dS" = (/obj/structure/lattice,/obj/structure/railing/mapped{dir = 4},/turf/simulated/open,/area/space)
"gb" = (/obj/structure/cable/green{icon_state = "1-2"},/obj/machinery/atmospherics/pipe/simple/hidden/supply,/obj/machinery/atmospherics/pipe/simple/hidden/scrubbers,/turf/simulated/floor/plating,/area/jelly/cryo)
"gS" = (/obj/machinery/ion_thruster{dir = 1},/turf/simulated/floor/airless,/area/space)
"gT" = (/obj/effect/airlock_helper{main_id = "jellyext1"; name = "Airlock Helper - Jelly Ext 1"},/turf/simulated/floor/plating,/area/space)
"kR" = (/obj/effect/floor_decal/industrial/warning{dir = 8},/obj/machinery/alarm{dir = 1},/obj/machinery/atmospherics/pipe/simple/hidden/scrubbers{dir = 5},/turf/simulated/floor/tiled/dark/monotile,/area/jelly/cryo)
"lI" = (/turf/simulated/open,/area/space)
"lT" = (/obj/machinery/cryopod,/turf/simulated/floor/tiled/techfloor/grid,/area/jelly/cryo)
"nl" = (/obj/structure/lattice,/obj/structure/railing/mapped{dir = 1},/turf/simulated/open,/area/space)
"nt" = (/obj/effect/airlock_helper{main_id = "jellyext2"; name = "Airlock Helper - Jelly Ext 2"},/turf/simulated/floor/plating,/area/space)
"or" = (/obj/effect/floor_decal/industrial/hatch/yellow,/obj/structure/cable/green{icon_state = "1-2"},/obj/machinery/atmospherics/pipe/simple/hidden/supply,/obj/machinery/atmospherics/pipe/simple/hidden/scrubbers,/turf/simulated/floor/tiled/techmaint,/area/jelly/cryo)
"oX" = (/obj/effect/floor_decal/industrial/warning{dir = 4},/turf/simulated/floor/tiled/dark/monotile,/area/jelly/cryo)
"qS" = (/obj/structure/lattice,/obj/structure/railing/mapped{dir = 8},/turf/simulated/open,/area/space)
"wS" = (/obj/machinery/cryopod{dir = 4},/turf/simulated/floor/tiled/techfloor/grid,/area/jelly/cryo)
"wW" = (/turf/simulated/floor/reinforced/airless,/area/space)
"zh" = (/obj/structure/lattice,/turf/simulated/open,/area/space)
"Bi" = (/obj/effect/floor_decal/industrial/warning{dir = 4},/obj/machinery/atmospherics/unary/vent_pump/on,/turf/simulated/floor/tiled/dark/monotile,/area/jelly/cryo)
"BZ" = (/obj/structure/lattice,/obj/structure/railing/mapped,/turf/simulated/open,/area/space)
"Cd" = (/obj/effect/floor_decal/industrial/warning{dir = 8},/turf/simulated/floor/tiled/dark/monotile,/area/jelly/cryo)
"GF" = (/turf/simulated/floor/tiled/techmaint,/area/space)
"Hs" = (/obj/machinery/computer/cryopod{pixel_y = 32},/obj/structure/cable/green{icon_state = "2-4"},/obj/machinery/atmospherics/pipe/simple/hidden/supply{dir = 6},/obj/machinery/atmospherics/pipe/simple/hidden/scrubbers{dir = 10},/turf/simulated/floor/tiled/dark/monotile,/area/jelly/cryo)
"Js" = (/obj/structure/ladder,/turf/simulated/floor/plating,/area/space)
"JJ" = (/obj/structure/railing/mapped{dir = 4},/obj/structure/railing/mapped{dir = 1},/obj/structure/ladder,/turf/simulated/floor/plating,/area/space)
"JU" = (/turf/simulated/wall/r_wall/prepainted,/area/jelly/cryo)
"Kp" = (/obj/effect/floor_decal/industrial/warning{dir = 4},/obj/machinery/power/apc,/obj/structure/cable/green{icon_state = "0-8"},/obj/machinery/atmospherics/pipe/simple/hidden/supply{dir = 9},/turf/simulated/floor/tiled/dark/monotile,/area/jelly/cryo)
"LC" = (/turf/simulated/floor/plating,/area/space)
"LZ" = (/turf/simulated/floor/airless,/area/space)
"OW" = (/obj/structure/lattice,/obj/structure/ladder,/turf/simulated/open,/area/space)
"Qa" = (/obj/effect/landmark{name = "Observer-Start"},/turf/simulated/wall/r_wall/prepainted,/area/jelly/cryo)
"RS" = (/obj/structure/railing/mapped{dir = 1},/turf/simulated/floor/plating,/area/space)
"XQ" = (/obj/effect/floor_decal/industrial/warning{dir = 8},/obj/machinery/atmospherics/unary/vent_scrubber/on,/turf/simulated/floor/tiled/dark/monotile,/area/jelly/cryo)

(1,1,1) = {"
aaaaaaaaaaaaaaaaaaaaaaaaaaaaaaaaaaaaaaaaaaaaaaaaaaaaaaaaaaaaaaaaaaaaaaaaaaaaaaaaaaaaaaaaaaaaaaaaaaaaaaaaaaaaaaaaaaaaaaaaaaaaaaaaaaaaaaaaaaaaaaaaaaaaaaaaaaaaaaaa
aaaaaaaaaaaaaaaaaaaaaaaaaaaaaaaaaaaaaaaaaaaaaaaaaaaaaaaaaaaaaaaaaaaaaaaaaaaaaaaaaaaaaaaaaaaaaaaaaaaaaaaaaaaaaaaaaaaaaaaaaaaaaaaaaaaaaaaaaaaaaaaaaaaaaaaaaaaaaaaa
aaaaaaaaaaaaaaaaaaaaaaaaaaaaaaaaaaaaaaaaaaaaaaaaaaaaaaaaaaaaaaaaaaaaaaaaaaaaaaaaaaaaaaaaaaaaaaaaaaaaaaaaaaaaaaaaaaaaaaaaaaaaaaaaaaaaaaaaaaaaaaaaaaaaaaaaaaaaaaaa
aaaaaaaaaaaaaaaaaaaaaaaaaaaaaaaaaaaaaaaaaaaaaaaaaaaaaaaaaaaaaaaaaaaaaaaaaaaaaaaaaaaaaaaaaaaaaaaaaaaaaaaaaaaaaaaaaaaaaaaaaaaaaaaaaaaaaaaaaaaaaaaaaaaaaaaaaaaaaaaa
aaaaaaaaaaaaaaaaaaaaaaaaaaaaaaaaaaaaaaaaaaaaaaaaaaaaaaaaaaaaaaaaaaaaaaaaaaaaaaaaaaaaaaaaaaaaaaaaaaaaaaaaaaaaaaaaaaaaaaaaaaaaaaaaaaaaaaaaaaaaaaaaaaaaaaaaaaaaaaaa
aaaaaaaaaaaaaaaaaaaaaaaaaaaaaaaaaaaaaaaaaaaaaaaaaaaaaaaaaaaaaaaaaaaaaaaaaaaaaaaaaaaaaaaaaaaaaaaaaaaaaaaaaaaaaaaaaaaaaaaaaaaaaaaaaaaaaaaaaaaaaaaaaaaaaaaaaaaaaaaa
aaaaaaaaaaaaaaaaaaaaaaaaaaaaaaaaaaaaaaaaaaaaaaaaaaaaaaaaaaaaaaaaaaaaaaaaaaaaaaaaaaaaaaaaaaaaaaaaaaaaaaaaaaaaaaaaaaaaaaaaaaaaaaaaaaaaaaaaaaaaaaaaaaaaaaaaaaaaaaaa
aaaaaaaaaaaaaaaaaaaaaaaaaaaaaaaaaaaaaaaaaaaaaaaaaaaaaaaaaaaaaaaaaaaaaaaaaaaaaaaaaaaaaaaaaaaaaaaaaaaaaaaaaaaaaaaaaaaaaaaaaaaaaaaaaaaaaaaaaaaaaaaaaaaaaaaaaaaaaaaa
aaaaaaaaaaaaaaaaaaaaaaaaaaaaaaaaaaaaaaaaaaaaaaaaaaaaaaaaaaaaaaaaaaaaaaaaaaaaaaaaaaaaaaaaaaaaaaaaaaaaaaaaaaaaaaaaaaaaaaaaaaaaaaaaaaaaaaaaaaaaaaaaaaaaaaaaaaaaaaaa
aaaaaaaaaaaaaaaaaaaaaaaaaaaaaaaaaaaaaaaaaaaaaaaaaaaaaaaaaaaaaaaaaaaaaaaaaaaaaaaaaaaaaaaaaaaaaaaaaaaaaaaaaaaaaaaaaaaaaaaaaaaaaaaaaaaaaaaaaaaaaaaaaaaaaaaaaaaaaaaa
aaaaaaaaaaaaaaaaaaaaaaaaaaaaaaaaaaaaaaaaaaaaaaaaaaaaaaaaaaaaaaaaaaaaaaaaaaaaaaaaaaaaaaaaaaaaaaaaaaaaaaaaaaaaaaaaaaaaaaaaaaaaaaaaaaaaaaaaaaaaaaaaaaaaaaaaaaaaaaaa
aaaaaaaaaaaaaaaaaaaaaaaaaaaaaaaaaaaaaaaaaaaaaaaaaaaaaaaaaaaaaaaaaaaaaaaaaaaaaaaaaaaaaaaaaaaaaaaaaaaaaaaaaaaaaaaaaaaaaaaaaaaaaaaaaaaaaaaaaaaaaaaaaaaaaaaaaaaaaaaa
aaaaaaaaaaaaaaaaaaaaaaaaaaaaaaaaaaaaaaaaaaaaaaaaaaaaaaaaaaaaaaaaaaaaaaaaaaaaaaaaaaaaaaaaaaaaaaaaaaaaaaaaaaaaaaaaaaaaaaaaaaaaaaaaaaaaaaaaaaaaaaaaaaaaaaaaaaaaaaaa
aaaaaaaaaaaaaaaaaaaaaaaaaaaaaaaaaaaaaaaaaaaaaaaaaaaaaaaaaaaaaaaaaaaaadadadadadadadadadaaaaaaaaaaaaaaaaaaaaaaaaaaaaaaaaaaaaaaaaaaaaaaaaaaaaaaaaaaaaaaaaaaaaaaaaaa
aaaaaaaaaaaaaaaaaaaaaaaaaaaaaaaaaaaaaaaaaaaaaaaaaaaaaaaaaaaaaaadadadadadadadadadadadadadadadaaaaaaaaaaaaaaaaaaaaaaaaaaaaaaaaaaaaaaaaaaaaaaaaaaaaaaaaaaaaaaaaaaaa
aaaaaaaaaaaaaaaaaaaaaaaaaaaaaaaaaaaaaaaaaaaaaaaaaaaaaaaaaaadadadadadadadadadadadadadadadadadadadaaaaaaaaaaaaaaaaaaaaaaaaaaaaaaaaaaaaaaaaaaaaaaaaaaaaaaaaaaaaaaaa
aaaaaaaaaaaaaaaaaaaaaaaaaaaaaaaaaaaaaaaaaaaaaaaaaaaaaaadadadadadadadadadadadadadadadadadadadadadadadaaaaaaaaaaaaaaaaaaaaaaaaaaaaaaaaaaaaaaaaaaaaaaaaaaaaaaaaaaaa
aaaaaaaaaaaaaaaaaaaaaaaaaaaaaaaaaaaaaaaaaaaaaaaaaaaaaaadadadadadadLCLCLCGFLCLCLCGFLCLCLCadadadadadadaaaaaaaaaaaaaaaaaaaaaaaaaaaaaaaaaaaaaaaaaaaaaaaaaaaaaaaaaaaa
aaaaaaaaaaaaaaaaaaaaaaaaaaaaaaaaaaaaaaaaaaaaaaaaaaaaaaadadadadadadLCLCLCadLCLCLCadLCLCLCadadadadadadaaaaaaaaaaaaaaaaaaaaaaaaaaaaaaaaaaaaaaaaaaaaaaaaaaaaaaaaaaaa
aaaaaaaaaaaaaaaaaaaaaaaaaaaaaaaaaaaaaaaaaaaaaaaaaaaaadadadadadadadadLCLCadadadadadLCLCadadadadadadadadaaaaaaaaaaaaaaaaaaaaaaaaaaaaaaaaaaaaaaaaaaaaaaaaaaaaaaaaaa
aaaaaaaaaaaaaaaaaaaaaaaaaaaaaaaaaaaaaaaaaaaaaaaaaaaaadadadLCLCLCLCadGFadadLCLCLCadadGFadLCLCLCLCadadadaaaaaaaaaaaaaaaaaaaaaaaaaaaaaaaaaaaaaaaaaaaaaaaaaaaaaaaaaa
aaaaaaaaaaaaaaaaaaaaaaaaaaaaaaaaaaaaaaaaaaaaaaaaaaaaadadadLCLCLCLCadLCadLCLCLCLCLCadLCadLCLCLCLCadadadaaaaaaaaaaaaaaaaaaaaaaaaaaaaaaaaaaaaaaaaaaaaaaaaaaaaaaaaaa
aaaaaaaaaaaaaaaaaaaaaaaaaaaaaaaaaaaaaaaaaaaaaaaaaaaaadadadLCLCLCLCadLCadLCLCLCLCLCadLCadLCLCLCLCadadadaaaaaaaaaaaaaaaaaaaaaaaaaaaaaaaaaaaaaaaaaaaaaaaaaaaaaaaaaa
aaaaaaaaaaaaaaaaaaaaaaaaaaaaaaaaaaaaaaaaaaaaaaaaaaadadadadLCLCLCLCadGFadadLCLCLCadadGFadLCLCLCLCadadadadaaaaaaaaaaaaaaaaaaaaaaaaaaaaaaaaaaaaaaaaaaaaaaaaaaaaaaaa
aaaaaaaaaaaaaaaaaaaaaaaaaaaaaaaaaaaaaaaaaaaaaaaaaaadadadadadadGFadadLCLCadadGFadadLCLCadadGFadadadadadadaaaaaaaaaaaaaaaaaaaaaaaaaaaaaaaaaaaaaaaaaaaaaaaaaaaaaaaa
aaaaaaaaaaaaaaaaaaaaaaaaaaaaaaaaaaaaaaaaaaaaaaaawWadadadLCLCLCLCLCadadLCLCLCLCLCLCLCadadLCLCLCLCLCadadadwWaaaaaaaaaaaaaaaaaaaaaaaaaaaaaaaaaaaaaaaaaaaaaaaaaaaaaa
aaaaaaaaaaaaaaaaaaaaaaaaaaaaaaaaaaaaaaaaaaaaaaaawWadadadLCLCLCLCLCLCLCLCLCLCLCLCLCLCLCLCLCLCLCLCLCadadadwWaaaaaaaaaaaaaaaaaaaaaaaaaaaaaaaaaaaaaaaaaaaaaaaaaaaaaa
aaaaaaaaaaaaaaaaaaaaaaaaaaaaaaaaaaaaaaaaaaaaaawWwWadadadLCLCLCLCLCLCadadadadLCadadadadLCLCLCLCLCLCadadadwWwWaaaaaaaaaaaaaaaaaaaaaaaaaaaaaaaaaaaaaaaaaaaaaaaaaaaa
aaaaaaaaaaaaaaaaaaaaaaaaaaaaaaaaaaaaaaaaaawWwWwWwWadadadadadadLCadadadOWzhadLCadzhOWadadadLCadadadadadadwWwWwWwWaaaaaaaaaaaaaaaaaaaaaaaaaaaaaaaaaaaaaaaaaaaaaaaa
aaaaaaaaaaaaaaaaaaaaaaaaaaaaaaaaaaaaaaaaaawWwWwWwWadadLCLCLCadLCadlIlIlIlIadLCadlIlIlIlIadLCadLCLCLCadadwWwWwWwWaaaaaaaaaaaaaaaaaaaaaaaaaaaaaaaaaaaaaaaaaaaaaaaa
aaaaaaaaaaaaaaaaaaaaaaaaaaaaaaaaaaaaaaaawWwWwWwWwWadadLCLCLCadLCadlIlIlIaTadLCadJJlIlIlIadLCadLCLCLCadadwWwWwWwWwWaaaaaaaaaaaaaaaaaaaaaaaaaaaaaaaaaaaaaaaaaaaaaa
aaaaaaaaaaaaaaaaaaaaaaaaaaaaaaaaaaaaaaaawWwWwWwWwWadadLCLCLCadLCadRSRSRSLCLCLCLCLCRSRSRSadLCadLCLCLCadadwWwWwWwWwWaaaaaaaaaaaaaaaaaaaaaaaaaaaaaaaaaaaaaaaaaaaaaa
aaaaaaaaaaaaaaaaaaaaaaaaaaaaaaaaaaaaaaaawWwWwWwWwWadadLCLCLCLCLCLCLCLCLCLCadLCadLCLCLCLCLCLCLCLCLCLCadadwWwWwWwWwWaaaaaaaaaaaaaaaaaaaaaaaaaaaaaaaaaaaaaaaaaaaaaa
aaaaaaaaaaaaaaaaaaaaaaaaaaaaaaaaaaaaaawWwWwWwWwWadadadLCLCLCadLCadadadnlnladLCadnlnladadadLCadLCLCLCadadadwWwWwWwWwWaaaaaaaaaaaaaaaaaaaaaaaaaaaaaaaaaaaaaaaaaaaa
aaaaaaaaaaaaaaaaaaaaaaaaaaaaaaaaaaaaaawWwWwWwWwWadadadadadadadLCLCLCadlIlIadLCadlIlIadLCLCLCadadadadadadadwWwWwWwWwWaaaaaaaaaaaaaaaaaaaaaaaaaaaaaaaaaaaaaaaaaaaa
aaaaaaaaaaaaaaaaaaaaaaaaaaaaaaaaaaaaaawWwWwWwWwWadadLCLCLCLCadLCLCLCadadadadLCadadadadLCLCLCadLCLCLCLCadadwWwWwWwWwWaaaaaaaaaaaaaaaaaaaaaaaaaaaaaaaaaaaaaaaaaaaa
aaaaaaaaaaaaaaaaaaaaaaaaaaaaaaaaaaaaaawWwWwWwWwWadadLCLCLCLCadLCLCadadlIlIdSLCqSlIlIadadLCLCadLCLCLCLCadadwWwWwWwWwWaaaaaaaaaaaaaaaaaaaaaaaaaaaaaaaaaaaaaaaaaaaa
aaaaaaaaaaaaaaaaaaaaaaaaaaaaaaaaaaaaaawWwWwWwWwWadadLCLCLCLCadLCLCadlIlIlIdSLCqSlIlIlIadLCLCadLCLCLCLCadadwWwWwWwWwWaaaaaaaaaaaaaaaaaaaaaaaaaaaaaaaaaaaaaaaaaaaa
aaaaaaaaaaaaaaaaaaaaaaaaaaaaaaaaaaaaaawWwWwWwWwWadadLCLCLCLCadLCadadlIadadadLCadadadlIadadLCadLCLCLCLCadadwWwWwWwWwWaaaaaaaaaaaaaaaaaaaaaaaaaaaaaaaaaaaaaaaaaaaa
aaaaaaaaaaaaaaaaaaaaaaaaaaaaaaaaaaaaaawWwWwWwWwWadadLCLCLCLCadLCadBZBZadLCLCLCLCLCadBZBZadLCadLCLCLCLCadadwWwWwWwWwWaaaaaaaaaaaaaaaaaaaaaaaaaaaaaaaaaaaaaaaaaaaa
aaaaaaaaaaaaaaaaaaaaaaaaaaaaaaaaaaaaaawWwWwWwWwWadadLCLCLCLCLCLCLCLCLCLCLCLCLCLCLCLCLCLCLCLCLCLCLCLCLCadadwWwWwWwWwWaaaaaaaaaaaaaaaaaaaaaaaaaaaaaaaaaaaaaaaaaaaa
aaaaaaaaaaaaaaaaaaaaaaaaaaaaaaaaaaaaaawWwWwWwWwWadadLCLCLCLCadLCadnlnladLCLCLCLCLCadnlnladLCadLCLCLCLCadadwWwWwWwWwWaaaaaaaaaaaaaaaaaaaaaaaaaaaaaaaaaaaaaaaaaaaa
aaaaaaaaaaaaaaaaaaaaaaaaaaaaaaaaaaaaaaaawWwWwWwWadadadLCadadadadadadlIadadadLCadadadlIadadadadadadLCadadadwWwWwWwWaaaaaaaaaaaaaaaaaaaaaaaaaaaaaaaaaaaaaaaaaaaaaa
aaaaaaaaaaaaaaaaaaaaaaaaaaaaaaaaaaaaaaaaaawWwWwWadadLCLCLCLCadLCLCadlIlIlIdSLCqSlIlIlIadLCLCadLCLCLCLCadadwWwWwWaaaaaaaaaaaaaaaaaaaaaaaaaaaaaaaaaaaaaaaaaaaaaaaa
aaaaaaaaaaaaaaaaaaaaaaaaaaaaaaaaaaaaaaaaaaaawWwWadadLCLCLCLCLCLCLCadadlIlIdSLCqSlIlIadadLCLCLCLCLCLCLCadadwWwWaaaaaaaaaaaaaaaaaaaaaaaaaaaaaaaaaaaaaaaaaaaaaaaaaa
aaaaaaaaaaaaaaaaaaaaaaaaaaaaaaaaaaaaaaaaaaaaaawWadadLCLCLCLCadadLCadadadadadLCadadadadadLCadadLCLCLCLCadadwWaaaaaaaaaaaaaaaaaaaaaaaaaaaaaaaaaaaaaaaaaaaaaaaaaaaa
aaaaaaaaaaaaaaaaaaaaaaaaaaaaaaaaaaaaaaaaaaaaaawWadadadLCadadadLCLCLCLCLCadLCLCLCadLCLCLCLCLCadadadLCadadadwWaaaaaaaaaaaaaaaaaaaaaaaaaaaaaaaaaaaaaaaaaaaaaaaaaaaa
aaaaaaaaaaaaaaaaaaaaaaaaaaaaaaaaaaaaaaaaaaaaaawWadadLCLCLCLCadLCadLCLCLCadJsLCJsadLCLCLCadLCadLCLCLCLCadadwWaaaaaaaaaaaaaaaaaaaaaaaaaaaaaaaaaaaaaaaaaaaaaaaaaaaa
aaaaaaaaaaaaaaaaaaaaaaaaaaaaaaaaaaaaaaaaaaaaaaaaadadLCLCLCLCadLCadLCLCLCadJsLCJsadLCLCLCadLCadLCLCLCLCadadaaaaaaaaaaaaaaaaaaaaaaaaaaaaaaaaaaaaaaaaaaaaaaaaaaaaaa
aaaaaaaaaaaaaaaaaaaaaaaaaaaaaaaaaaaaaaaaaaaaaaaaadadadadadLCadLCadLCLCLCLCLCLCLCLCLCLCLCadLCadLCadadadadadaaaaaaaaaaaaaaaaaaaaaaaaaaaaaaaaaaaaaaaaaaaaaaaaaaaaaa
aaaaaaaaaaaaaaaaaaaaaaaaaaaaaaaaaaaaaaaaaaaaaaaaadadLCLCadLCadLCadLCLCLCJUJUJUJUJULCLCLCadLCadLCadLCLCadadaaaaaaaaaaaaaaaaaaaaaaaaaaaaaaaaaaaaaaaaaaaaaaaaaaaaaa
aaaaaaaaaaaaaaaaaaaaaaaaaaaaaaaaaaaaaaaaaaaaaaadadadLCLCadLCadLCLCLCLCJUJUJUJUJUJUJULCLCLCLCadLCadLCLCadadadaaaaaaaaaaaaaaaaaaaaaaaaaaaaaaaaaaaaaaaaaaaaaaaaaaaa
aaaaaaaaaaaaaaaaaaaaaaaaaaaaaaaaaaaaaaaaaaaaaaadadadLCLCLCLCadLCadadadJUwSCdQaoXlTJUadadadLCadLCLCLCLCadadadaaaaaaaaaaaaaaaaaaaaaaaaaaaaaaaaaaaaaaaaaaaaaaaaaaaa
aaaaaaaaaaaaaaaaaaaaaaaaaaaaaaaaaaaaaaaaaaaaadadadadadadadLCadLCLCLCadJUwSXQJUBilTJUadLCLCLCadLCadadadadadadadaaaaaaaaaaaaaaaaaaaaaaaaaaaaaaaaaaaaaaaaaaaaaaaaaa
aaaaaaaaaaaaaaaaaaaaaaaaaaaaaaaaaaaaaaaaaaaaadadadLCLCadLCLCadLCadadadJUwSkRHsKplTJUadadadLCadLCLCadLCLCadadadaaaaaaaaaaaaaaaaaaaaaaaaaaaaaaaaaaaaaaaaaaaaaaaaaa
aaaaaaaaaaaaaaaaaaaaaaaaaaaaaaaaaaaaaaaaaaaaadadLCLCLCadLCLCadLCLCLCLCJUJUJUorJUJUJULCLCLCLCadLCLCadLCLCLCadadaaaaaaaaaaaaaaaaaaaaaaaaaaaaaaaaaaaaaaaaaaaaaaaaaa
aaaaaaaaaaaaaaaaaaaaaaaaaaaaaaaaaaaaaaaaaaaaadadLCLCLCLCLCLCadLCLCLCLCadJUJUgbJUJUadLCLCLCLCadLCLCLCLCLCLCadadaaaaaaaaaaaaaaaaaaaaaaaaaaaaaaaaaaaaaaaaaaaaaaaaaa
aaaaaaaaaaaaaaaaaaaaaaaaaaaaaaaaaaaaaaaaaaaaadadLCLCLCadadadadadadadLCadLCLCLCLCLCadLCadadadadadadadLCLCLCadadaaaaaaaaaaaaaaaaaaaaaaaaaaaaaaaaaaaaaaaaaaaaaaaaaa
aaaaaaaaaaaaaaaaaaaaaaaaaaaaaaaaaaaaaaaaaaaaadadLCLCLCLCLCLCLCLCLCLCLCLCLCadadadLCLCLCLCLCLCLCLCLCLCLCLCLCadadaaaaaaaaaaaaaaaaaaaaaaaaaaaaaaaaaaaaaaaaaaaaaaaaaa
aaaaaaaaaaaaaaaaaaaaaaaaaaaaaaaaaaaaaaaaaaaaadadLCLCLCadadadadLCadLCLCLCLCadLCadLCLCLCLCadLCadadadadLCLCLCadadaaaaaaaaaaaaaaaaaaaaaaaaaaaaaaaaaaaaaaaaaaaaaaaaaa
aaaaaaaaaaaaaaaaaaaaaaaaaaaaaaaaaaaaaaaaaaaaadadLCLCadadadadadgTadLCLCLCLCLCLCLCLCLCLCLCadntadadadadadLCLCadadaaaaaaaaaaaaaaaaaaaaaaaaaaaaaaaaaaaaaaaaaaaaaaaaaa
aaaaaaaaaaaaaaaaaaaaaaaaaaaaaaaaaaaaaaaaaaaaadadLCLCadadadadadLCadadadadadadLCadadadadadadLCadadadadadLCLCadadaaaaaaaaaaaaaaaaaaaaaaaaaaaaaaaaaaaaaaaaaaaaaaaaaa
aaaaaaaaaaaaaaaaaaaaaaaaaaaaaaaaaaaaaaaaaaaaadadLCLCadadwWwWLZLZwWwWadLCLCLCLCLCLCLCadwWLZLZLZwWwWadadLCLCadadaaaaaaaaaaaaaaaaaaaaaaaaaaaaaaaaaaaaaaaaaaaaaaaaaa
aaaaaaaaaaaaaaaaaaaaaaaaaaaaaaaaaaaaaaaaaaadadadadadadadadwWLZLZLZLZadLCLCLCLCLCLCLCadLZLZLZLZwWadadadadadadadadaaaaaaaaaaaaaaaaaaaaaaaaaaaaaaaaaaaaaaaaaaaaaaaa
aaaaaaaaaaaaaaaaaaaaaaaaaaaaaaaaaaaaaaaaaaadadadadadadadadaaLZLZwWwWadadadLCLCLCadadadwWwWLZLZaaadadadadadadadadaaaaaaaaaaaaaaaaaaaaaaaaaaaaaaaaaaaaaaaaaaaaaaaa
aaaaaaaaaaaaaaaaaaaaaaaaaaaaaaaaaaaaaaaaaaaaadgSgSgSgSadaaaaaaLZwWwWadadadadadadadadadwWwWLZaaaaaaadgSgSgSgSadaaaaaaaaaaaaaaaaaaaaaaaaaaaaaaaaaaaaaaaaaaaaaaaaaa
aaaaaaaaaaaaaaaaaaaaaaaaaaaaaaaaaaaaaaaaaaaaaaaaaaaaaaaaaaaaaaaaaawWwWadgSgSgSgSgSadwWwWaaaaaaaaaaaaaaaaaaaaaaaaaaaaaaaaaaaaaaaaaaaaaaaaaaaaaaaaaaaaaaaaaaaaaaaa
aaaaaaaaaaaaaaaaaaaaaaaaaaaaaaaaaaaaaaaaaaaaaaaaaaaaaaaaaaaaaaaaaaaaaaaaaaaaaaaaaaaaaaaaaaaaaaaaaaaaaaaaaaaaaaaaaaaaaaaaaaaaaaaaaaaaaaaaaaaaaaaaaaaaaaaaaaaaaaaa
aaaaaaaaaaaaaaaaaaaaaaaaaaaaaaaaaaaaaaaaaaaaaaaaaaaaaaaaaaaaaaaaaaaaaaaaaaaaaaaaaaaaaaaaaaaaaaaaaaaaaaaaaaaaaaaaaaaaaaaaaaaaaaaaaaaaaaaaaaaaaaaaaaaaaaaaaaaaaaaa
aaaaaaaaaaaaaaaaaaaaaaaaaaaaaaaaaaaaaaaaaaaaaaaaaaaaaaaaaaaaaaaaaaaaaaaaaaaaaaaaaaaaaaaaaaaaaaaaaaaaaaaaaaaaaaaaaaaaaaaaaaaaaaaaaaaaaaaaaaaaaaaaaaaaaaaaaaaaaaaa
aaaaaaaaaaaaaaaaaaaaaaaaaaaaaaaaaaaaaaaaaaaaaaaaaaaaaaaaaaaaaaaaaaaaaaaaaaaaaaaaaaaaaaaaaaaaaaaaaaaaaaaaaaaaaaaaaaaaaaaaaaaaaaaaaaaaaaaaaaaaaaaaaaaaaaaaaaaaaaaa
aaaaaaaaaaaaaaaaaaaaaaaaaaaaaaaaaaaaaaaaaaaaaaaaaaaaaaaaaaaaaaaaaaaaaaaaaaaaaaaaaaaaaaaaaaaaaaaaaaaaaaaaaaaaaaaaaaaaaaaaaaaaaaaaaaaaaaaaaaaaaaaaaaaaaaaaaaaaaaaa
aaaaaaaaaaaaaaaaaaaaaaaaaaaaaaaaaaaaaaaaaaaaaaaaaaaaaaaaaaaaaaaaaaaaaaaaaaaaaaaaaaaaaaaaaaaaaaaaaaaaaaaaaaaaaaaaaaaaaaaaaaaaaaaaaaaaaaaaaaaaaaaaaaaaaaaaaaaaaaaa
aaaaaaaaaaaaaaaaaaaaaaaaaaaaaaaaaaaaaaaaaaaaaaaaaaaaaaaaaaaaaaaaaaaaaaaaaaaaaaaaaaaaaaaaaaaaaaaaaaaaaaaaaaaaaaaaaaaaaaaaaaaaaaaaaaaaaaaaaaaaaaaaaaaaaaaaaaaaaaaa
aaaaaaaaaaaaaaaaaaaaaaaaaaaaaaaaaaaaaaaaaaaaaaaaaaaaaaaaaaaaaaaaaaaaaaaaaaaaaaaaaaaaaaaaaaaaaaaaaaaaaaaaaaaaaaaaaaaaaaaaaaaaaaaaaaaaaaaaaaaaaaaaaaaaaaaaaaaaaaaa
aaaaaaaaaaaaaaaaaaaaaaaaaaaaaaaaaaaaaaaaaaaaaaaaaaaaaaaaaaaaaaaaaaaaaaaaaaaaaaaaaaaaaaaaaaaaaaaaaaaaaaaaaaaaaaaaaaaaaaaaaaaaaaaaaaaaaaaaaaaaaaaaaaaaaaaaaaaaaaaa
aaaaaaaaaaaaaaaaaaaaaaaaaaaaaaaaaaaaaaaaaaaaaaaaaaaaaaaaaaaaaaaaaaaaaaaaaaaaaaaaaaaaaaaaaaaaaaaaaaaaaaaaaaaaaaaaaaaaaaaaaaaaaaaaaaaaaaaaaaaaaaaaaaaaaaaaaaaaaaaa
aaaaaaaaaaaaaaaaaaaaaaaaaaaaaaaaaaaaaaaaaaaaaaaaaaaaaaaaaaaaaaaaaaaaaaaaaaaaaaaaaaaaaaaaaaaaaaaaaaaaaaaaaaaaaaaaaaaaaaaaaaaaaaaaaaaaaaaaaaaaaaaaaaaaaaaaaaaaaaaa
aaabaaacaaaaaaaaaaaaaaaaaaaaaaaaaaaaaaaaaaaaaaaaaaaaaaaaaaaaaaaaaaaaaaaaaaaaaaaaaaaaaaaaaaaaaaaaaaaaaaaaaaaaaaaaaaaaaaaaaaaaaaaaaaaaaaaaaaaaaaaaaaaaaaaaaaaaaaaa
aaaaaaaaaaaaaaaaaaaaaaaaaaaaaaaaaaaaaaaaaaaaaaaaaaaaaaaaaaaaaaaaaaaaaaaaaaaaaaaaaaaaaaaaaaaaaaaaaaaaaaaaaaaaaaaaaaaaaaaaaaaaaaaaaaaaaaaaaaaaaaaaaaaaaaaaaaaaaaaa
"}
