"aW" = (/obj/machinery/light/small{dir = 4; icon_state = "bulb_map"},/obj/structure/closet/radiation,/obj/effect/floor_decal/industrial/outline/yellow,/turf/simulated/floor/tiled/techfloor/grid,/area/lowpop/eng)
"bv" = (/obj/machinery/button/access/interior{id_tag = "utility_shuttle"; pixel_x = 25; pixel_y = -4},/obj/structure/bed/chair/shuttle/blue{dir = 8},/turf/simulated/floor/tiled/monotile,/area/ship/lowpop_shuttle)
"cf" = (/obj/machinery/button/blast_door{id_tag = "radaway"; name = "Radiation shields"; pixel_y = 24},/obj/machinery/vending/engineering,/turf/simulated/floor/tiled/techfloor/grid,/area/lowpop/eng)
"cL" = (/turf/simulated/wall/prepainted,/area/lowpop/eng)
"dF" = (/obj/machinery/computer/ship/engines,/turf/simulated/floor/tiled/monotile,/area/ship/lowpop_shuttle)
"dG" = (/obj/machinery/ion_thruster{dir = 1},/turf/simulated/floor/reinforced/airless,/area/ship/lowpop_shuttle)
"ec" = (/obj/machinery/portable_atmospherics/powered/scrubber,/obj/effect/floor_decal/industrial/outline/yellow,/turf/simulated/floor/tiled/techfloor/grid,/area/ship/lowpop_shuttle)
"hn" = (/obj/effect/floor_decal/corner_techfloor_grid{dir = 5},/obj/effect/floor_decal/techfloor/corner{dir = 4},/obj/effect/floor_decal/techfloor/corner{dir = 1},/obj/structure/cable{d1 = 1; d2 = 8; icon_state = "1-8"},/obj/structure/cable{d1 = 2; d2 = 8; icon_state = "2-8"},/turf/simulated/floor/tiled/techfloor,/area/lowpop/eng)
"ic" = (/obj/structure/cable{d1 = 1; d2 = 2; icon_state = "1-2"},/turf/simulated/floor/tiled/steel_grid,/area/ship/lowpop_shuttle)
"iB" = (/obj/machinery/ion_thruster{dir = 1},/turf/simulated/floor/plating,/area/ship/lowpop_shuttle)
"jX" = (/obj/machinery/atmospherics/portables_connector{dir = 1},/obj/machinery/portable_atmospherics/canister/air/airlock{start_pressure = 730},/obj/effect/floor_decal/industrial/outline/yellow,/turf/simulated/floor/tiled/techfloor/grid,/area/ship/lowpop_shuttle)
"ko" = (/turf/space,/area/space)
"kE" = (/obj/effect/floor_decal/techfloor{dir = 4},/obj/effect/floor_decal/techfloor{dir = 8},/obj/structure/cable{d1 = 2; d2 = 4; icon_state = "2-4"},/turf/simulated/floor/tiled/techfloor,/area/lowpop/eng)
"kW" = (/obj/effect/floor_decal/techfloor{dir = 4},/obj/effect/floor_decal/techfloor{dir = 8},/obj/effect/landmark/start{name = "Engineer"},/turf/simulated/floor/tiled/techfloor,/area/lowpop/eng)
"lC" = (/obj/machinery/door/airlock/external/bolted{id_tag = "utility_shuttle_out"},/obj/machinery/button/access/exterior{id_tag = "utility_shuttle"; pixel_x = -6; pixel_y = 25},/obj/effect/floor_decal/industrial/hatch/yellow,/obj/structure/cable{d1 = 4; d2 = 8; icon_state = "4-8"; pixel_y = 0},/turf/simulated/floor/tiled/techfloor/grid,/area/ship/lowpop_shuttle)
"lN" = (/turf/simulated/floor/tiled/techmaint,/area/lowpop/dock)
"oe" = (/obj/machinery/button/access/interior{id_tag = "utility_shuttle_dock"; pixel_x = 25; pixel_y = -4},/obj/structure/cable{d1 = 1; d2 = 2; icon_state = "1-2"},/obj/structure/cable{icon_state = "2-8"},/turf/simulated/floor/tiled/techmaint,/area/lowpop/dock)
"pj" = (/obj/random/junk,/obj/random/tool,/turf/simulated/floor/tiled/techmaint,/area/lowpop/dock)
"pE" = (/obj/structure/bed/chair/shuttle/white{dir = 1},/turf/simulated/floor/tiled/steel_grid,/area/ship/lowpop_shuttle)
"pS" = (/obj/machinery/door/blast/regular{id_tag = "radaway"},/obj/structure/cable{d1 = 1; d2 = 2; icon_state = "1-2"},/turf/simulated/floor/greengrid,/area/lowpop/eng)
"pZ" = (/obj/effect/floor_decal/techfloor{dir = 1},/obj/structure/cable{d1 = 4; d2 = 8; icon_state = "4-8"; pixel_y = 0},/turf/simulated/floor/tiled/techfloor,/area/lowpop/eng)
"ql" = (/obj/machinery/power/apc{dir = 2; name = "south bump"; pixel_y = -24},/obj/machinery/atmospherics/pipe/simple/visible{dir = 9},/obj/structure/closet/crate,/obj/item/tank/oxygen,/obj/item/tank/oxygen,/obj/item/tank/oxygen,/obj/item/clothing/suit/space/void/engineering/salvage,/obj/item/clothing/suit/space/void/engineering/salvage,/obj/item/clothing/suit/space/void/engineering/salvage,/obj/item/clothing/head/helmet/space/void/engineering/salvage,/obj/item/clothing/head/helmet/space/void/engineering/salvage,/obj/item/clothing/head/helmet/space/void/engineering/salvage,/obj/structure/cable,/turf/simulated/floor/tiled/techmaint,/area/lowpop/dock)
"qO" = (/obj/effect/floor_decal/industrial/hatch/yellow,/obj/machinery/door/airlock/hatch/autoname/engineering,/obj/structure/cable{d1 = 1; d2 = 2; icon_state = "1-2"},/turf/simulated/floor/tiled/techfloor/grid,/area/lowpop/eng)
"rZ" = (/obj/machinery/light/small,/obj/effect/floor_decal/corner_techfloor_grid{dir = 5},/obj/effect/floor_decal/techfloor/corner{dir = 1},/obj/effect/floor_decal/techfloor/corner{dir = 4},/obj/structure/cable{d1 = 4; d2 = 8; icon_state = "4-8"; pixel_y = 0},/obj/effect/landmark/start{name = "Engineer"},/turf/simulated/floor/tiled/techfloor,/area/lowpop/eng)
"sY" = (/obj/machinery/light/small{dir = 1},/obj/machinery/embedded_controller/radio/airlock/docking_port{cycle_to_external_air = 1; id_tag = "utility_shuttle"; pixel_y = 25; tag_airpump = "utility_shuttle_pump"; tag_chamber_sensor = "utility_shuttle_sensor"; tag_exterior_door = "utility_shuttle_out"; tag_interior_door = "utility_shuttle_in"},/obj/machinery/airlock_sensor{id_tag = "utility_shuttle_sensor"; pixel_y = 21},/obj/machinery/atmospherics/unary/vent_pump/high_volume/external_air{dir = 4; id_tag = "utility_shuttle_pump"},/obj/effect/catwalk_plated,/obj/structure/cable{d1 = 4; d2 = 8; icon_state = "4-8"; pixel_y = 0},/turf/simulated/floor/plating,/area/ship/lowpop_shuttle)
"td" = (/obj/effect/floor_decal/techfloor{dir = 4},/obj/effect/floor_decal/techfloor{dir = 8},/turf/simulated/floor/tiled/techfloor,/area/lowpop/eng)
"tH" = (/obj/machinery/atmospherics/pipe/simple/visible{dir = 4},/obj/machinery/door/airlock/external/bolted{id_tag = "utility_shuttle_in"},/obj/effect/floor_decal/industrial/hatch/yellow,/obj/structure/cable{d1 = 4; d2 = 8; icon_state = "4-8"; pixel_y = 0},/turf/simulated/floor/tiled/techfloor/grid,/area/ship/lowpop_shuttle)
"uz" = (/obj/structure/closet/crate/uranium,/obj/item/stack/material/uranium/ten,/obj/item/stack/material/uranium/ten,/obj/item/stack/material/uranium/ten,/obj/effect/floor_decal/industrial/outline/yellow,/turf/simulated/floor/tiled/techfloor/grid,/area/lowpop/eng)
"vb" = (/obj/machinery/light/small,/turf/simulated/floor/tiled/techmaint,/area/lowpop/dock)
"wm" = (/obj/machinery/recharge_station,/turf/simulated/floor/tiled/techfloor/grid,/area/lowpop/eng)
"xo" = (/obj/machinery/computer/ship/sensors{dir = 1},/turf/simulated/floor/tiled/monotile,/area/ship/lowpop_shuttle)
"ya" = (/obj/machinery/atmospherics/unary/vent_pump/high_volume/external_air{id_tag = "utility_shuttle_pump_out_internal"},/obj/effect/catwalk_plated,/turf/simulated/floor/plating,/area/ship/lowpop_shuttle)
"yx" = (/obj/structure/closet/crate,/obj/effect/floor_decal/industrial/outline/yellow,/obj/item/storage/toolbox/mechanical,/obj/item/tape_roll,/turf/simulated/floor/tiled/techmaint,/area/lowpop/dock)
"Af" = (/obj/machinery/door/airlock/external/bolted{id_tag = "utility_shuttle_dock_out"},/obj/machinery/button/access/exterior{id_tag = "utility_shuttle_dock"; pixel_x = 6; pixel_y = -25},/obj/effect/floor_decal/industrial/hatch/yellow,/obj/structure/cable{d1 = 4; d2 = 8; icon_state = "4-8"; pixel_y = 0},/turf/simulated/floor/tiled/techfloor/grid,/area/lowpop/dock)
"BD" = (/obj/machinery/atmospherics/pipe/simple/visible,/turf/simulated/wall/titanium,/area/ship/lowpop_shuttle)
"BF" = (/obj/effect/floor_decal/industrial/outline/yellow,/obj/machinery/vending/materials{dir = 1},/turf/simulated/floor/tiled/techmaint,/area/lowpop/dock)
"BZ" = (/obj/machinery/atmospherics/pipe/simple/visible{dir = 4},/obj/machinery/door/airlock/external/bolted{id_tag = "utility_shuttle_dock_in"},/obj/effect/floor_decal/industrial/hatch/yellow,/obj/structure/cable{d1 = 4; d2 = 8; icon_state = "4-8"; pixel_y = 0},/turf/simulated/floor/tiled/techfloor/grid,/area/lowpop/dock)
"CA" = (/obj/machinery/atm{desc = "For all your monetary needs! Wait, is it really needed here?.."; pixel_x = -28},/turf/simulated/floor/tiled/techmaint,/area/lowpop/dock)
"CS" = (/turf/simulated/wall/r_wall/prepainted,/area/lowpop/eng)
"Db" = (/obj/machinery/atmospherics/unary/vent_pump/high_volume/external_air{dir = 8; id_tag = "utility_shuttle_dock_pump"},/obj/machinery/embedded_controller/radio/airlock/docking_port{id_tag = "utility_shuttle_dock"; pixel_y = 25; tag_airpump = "utility_shuttle_dock_pump"; tag_chamber_sensor = "utility_shuttle_dock_sensor"; tag_exterior_door = "utility_shuttle_dock_out"; tag_interior_door = "utility_shuttle_dock_in"},/obj/machinery/airlock_sensor{id_tag = "utility_shuttle_dock_sensor"; pixel_y = -24},/obj/effect/catwalk_plated,/obj/structure/cable{d1 = 4; d2 = 8; icon_state = "4-8"; pixel_y = 0},/turf/simulated/floor/plating,/area/lowpop/dock)
"Ds" = (/obj/machinery/atmospherics/pipe/simple/visible{dir = 5},/turf/simulated/floor/reinforced/airless,/area/ship/lowpop_shuttle)
"Dz" = (/obj/machinery/power/apc{dir = 4},/obj/structure/table/steel_reinforced,/obj/machinery/cell_charger,/obj/structure/cable{d2 = 8; icon_state = "0-8"},/obj/random/powercell,/obj/random/powercell,/obj/random/powercell,/turf/simulated/floor/tiled/techfloor/grid,/area/lowpop/eng)
"DR" = (/obj/machinery/light/small{dir = 4; icon_state = "bulb_map"},/obj/machinery/mech_recharger,/mob/living/exosuit/premade/powerloader,/turf/simulated/floor/tiled/steel_grid,/area/ship/lowpop_shuttle)
"Fh" = (/obj/machinery/atmospherics/pipe/simple/visible{dir = 10},/obj/structure/cable{d1 = 1; d2 = 8; icon_state = "1-8"},/turf/simulated/floor/tiled/steel_grid,/area/ship/lowpop_shuttle)
"Fr" = (/turf/simulated/floor/tiled/steel_grid,/area/ship/lowpop_shuttle)
"Gi" = (/obj/effect/overmap/visitable/ship/lowpop,/obj/machinery/atmospherics/pipe/zpipe/up{dir = 4},/turf/simulated/floor/tiled/techmaint,/area/lowpop/dock)
"GS" = (/obj/effect/wallframe_spawn/reinforced/titanium,/turf/simulated/floor/plating,/area/ship/lowpop_shuttle)
"Ia" = (/obj/machinery/computer/ship/helm,/turf/simulated/floor/tiled/monotile,/area/ship/lowpop_shuttle)
"Jb" = (/obj/effect/floor_decal/techfloor{dir = 1},/obj/effect/landmark/start{name = "Engineer"},/turf/simulated/floor/tiled/techfloor,/area/lowpop/eng)
"Jk" = (/obj/machinery/atmospherics/pipe/simple/visible,/obj/structure/cable{d1 = 1; d2 = 2; icon_state = "1-2"},/turf/simulated/floor/tiled/techmaint,/area/lowpop/dock)
"JU" = (/obj/machinery/atmospherics/portables_connector{dir = 4; icon_state = "map_connector"},/obj/machinery/portable_atmospherics/canister/air/airlock{start_pressure = 2920},/turf/simulated/floor/tiled/techmaint,/area/lowpop/dock)
"Kd" = (/turf/simulated/wall/titanium,/area/ship/lowpop_shuttle)
"Kh" = (/obj/effect/overmap/visitable/ship/landable/lowpop_shuttle,/obj/effect/shuttle_landmark/lowpop_dock,/obj/machinery/power/port_gen/pacman{anchored = 1},/obj/machinery/power/apc{dir = 2; name = "south bump"; pixel_y = -24},/obj/structure/cable{d2 = 4; icon_state = "0-4"},/turf/simulated/floor/tiled/monotile,/area/ship/lowpop_shuttle)
"Kw" = (/obj/machinery/computer/shuttle_control/explore/lowpop,/turf/simulated/floor/tiled/monotile,/area/ship/lowpop_shuttle)
"Md" = (/obj/structure/bed/chair/shuttle/blue{dir = 8},/turf/simulated/floor/tiled/monotile,/area/ship/lowpop_shuttle)
"Ns" = (/obj/structure/ladder,/obj/machinery/light/small{dir = 1; icon_state = "bulb_map"},/obj/structure/cable{d2 = 4; icon_state = "0-4"},/obj/structure/cable{d1 = 16; d2 = 0; icon_state = "16-0"},/turf/simulated/floor/tiled/techmaint,/area/lowpop/dock)
"PD" = (/obj/machinery/atmospherics/pipe/simple/visible{dir = 4},/obj/machinery/portable_atmospherics/powered/scrubber,/turf/simulated/floor/tiled/techmaint,/area/lowpop/dock)
"QT" = (/obj/machinery/light/small,/obj/effect/floor_decal/techfloor{dir = 1},/obj/item/storage/briefcase/inflatable,/obj/item/storage/briefcase/inflatable,/turf/simulated/floor/tiled/techfloor,/area/lowpop/eng)
"RQ" = (/turf/simulated/floor/reinforced/airless,/area/ship/lowpop_shuttle)
"Su" = (/obj/structure/closet/crate,/obj/effect/floor_decal/industrial/outline/yellow,/obj/item/stack/material/deuterium/fifty,/obj/item/stack/material/deuterium/fifty,/turf/simulated/floor/tiled/techmaint,/area/lowpop/dock)
"Tn" = (/obj/item/extinguisher,/obj/machinery/fabricator,/turf/simulated/floor/tiled/techmaint,/area/lowpop/dock)
"Ui" = (/obj/machinery/light/small{dir = 8; icon_state = "bulb_map"},/turf/simulated/floor/tiled/steel_grid,/area/ship/lowpop_shuttle)
"Uz" = (/obj/machinery/atmospherics/pipe/manifold/visible{dir = 1},/obj/structure/cable{d1 = 1; d2 = 2; icon_state = "1-2"},/obj/structure/cable{d1 = 1; d2 = 4; icon_state = "1-4"},/turf/simulated/floor/tiled/techmaint,/area/lowpop/dock)
"Va" = (/obj/machinery/atmospherics/unary/vent_pump/high_volume/external_air{dir = 8; id_tag = "utility_shuttle_pump_out_external"},/turf/simulated/floor/reinforced/airless,/area/ship/lowpop_shuttle)
"Vl" = (/obj/structure/cable{d1 = 2; d2 = 8; icon_state = "2-8"},/obj/machinery/hologram/holopad/longrange,/turf/simulated/floor/tiled/steel_grid,/area/ship/lowpop_shuttle)
"VR" = (/obj/machinery/power/shield_generator,/turf/simulated/floor/tiled/techfloor/grid,/area/lowpop/eng)
"VW" = (/obj/structure/stairs/west,/turf/simulated/floor/tiled/techmaint,/area/lowpop/dock)
"Wk" = (/obj/machinery/shipsensors/weak,/turf/simulated/floor/plating,/area/ship/lowpop_shuttle)
"WC" = (/turf/simulated/wall/prepainted,/area/lowpop/dock)
"WS" = (/obj/machinery/portable_atmospherics/canister/oxygen,/obj/effect/floor_decal/industrial/outline/yellow,/obj/machinery/light/small{dir = 4; icon_state = "bulb_map"},/turf/simulated/floor/tiled/techfloor/grid,/area/ship/lowpop_shuttle)
"WX" = (/obj/effect/floor_decal/techfloor{dir = 1},/obj/structure/cable{d1 = 1; d2 = 4; icon_state = "1-4"},/turf/simulated/floor/tiled/techfloor,/area/lowpop/eng)
"Xn" = (/obj/machinery/power/port_gen/pacman/super/potato,/obj/machinery/light/small{dir = 8; icon_state = "bulb_map"},/obj/effect/floor_decal/industrial/warning/full,/obj/structure/cable{d2 = 2; icon_state = "0-2"},/turf/simulated/floor/greengrid,/area/lowpop/eng)
"XH" = (/obj/machinery/power/smes/buildable/max_cap_in_out,/obj/structure/sign{icon_state = "radiation"; pixel_x = 0; pixel_y = 32},/obj/structure/cable{d2 = 2; icon_state = "0-2"},/turf/simulated/floor/tiled/techfloor/grid,/area/lowpop/eng)
"Zr" = (/obj/machinery/power/terminal{dir = 8},/obj/effect/floor_decal/techfloor{dir = 8},/obj/effect/floor_decal/techfloor{dir = 4},/obj/structure/cable,/turf/simulated/floor/tiled/techfloor,/area/lowpop/eng)

(1,1,1) = {"
kokokokokokokokokokokokokokokokokokokokokokokokokokokokokokokokokokokokokokokokokokokokokokokokokokokokokokokokokokokokokokokokokokokokokokokokokokokokokokokoko
kokokokokokokokokokokokokokokokokokokokokokokokokokokokokokokokokokokokokokokokokokokokokokokokokokokokokokokokokokokokokokokokokokokokokokokokokokokokokokokoko
kokokokokokokokokokokokokokokokokokokokokokokokokokokokokokokokokokokokokokokokokokokokokokokokokokokokokokokokokokokokokokokokokokokokokokokokokokokokokokokoko
kokokokokokokokokokokokokokokokokokokokokokokokokokokokokokokokokokokokokokokokokokokokokokokokokokokokokokokokokokokokokokokokokokokokokokokokokokokokokokokoko
kokokokokokokokokokokokokokokokokokokokokokokokokokokokokokokokokokokokokokokokokokokokokokokokokokokokokokokokokokokokokokokokokokokokokokokokokokokokokokokoko
kokokokokokokokokokokokokokokokokokokokokokokokokokokokokokokokokokokokokokokokokokokokokokokokokokokokokokokokokokokokokokokokokokokokokokokokokokokokokokokoko
kokokokokokokokokokokokokokokokokokokokokokokokokokokokokokokokokokokokokokokokokokokokokokokokokokokokokokokokokokokokokokokokokokokokokokokokokokokokokokokoko
kokokokokokokokokokokokokokokokokokokokokokokokokokokokokokokokokokokokokokokokokokokokokokokokokokokokokokokokokokokokokokokokokokokokokokokokokokokokokokokoko
kokokokokokokokokokokokokokokokokokokokokokokokokokokokokokokokokokokokokokokokokokokokokokokokokokokokokokokokokokokokokokokokokokokokokokokokokokokokokokokoko
kokokokokokokokokokokokokokokokokokokokokokokokokokokokokokokokokokokokokokokokokokokokokokokokokokokokokokokokokokokokokokokokokokokokokokokokokokokokokokokoko
kokokokokokokokokokokokokokokokokokokokokokokokokokokokokokokokokokokokokokokokokokokokokokokokokokokokokokokokokokokokokokokokokokokokokokokokokokokokokokokoko
kokokokokokokokokokokokokokokokokokokokokokokokokokokokokokokokokokokokokokokokokokokokokokokokokokokokokokokokokokokokokokokokokokokokokokokokokokokokokokokoko
kokokokokokokokokokokokokokokokokokokokokokokokokokokokokokokokokokokokokokokokokokokokokokokokokokokokokokokokokokokokokokokokokokokokokokokokokokokokokokokoko
kokokokokokokokokokokokokokokokokokokokokokokokokokokokokokokokokokokokokokokokokokokokokokokokokokokokokokokokokokokokokokokokokokokokokokokokokokokokokokokoko
kokokokokokokokokokokokokokokokokokokokokokokokokokokokokokokokokokokokokokokokokokokokokokokokokokokokokokokokokokokokokokokokokokokokokokokokokokokokokokokoko
kokokokokokokokokokokokokokokokokokokokokokokokokokokokokokokokokokokokokokokokokokokokokokokokokokokokokokokokokokokokokokokokokokokokokokokokokokokokokokokoko
kokokokokokokokokokokokokokokokokokokokokokokokokokokokokokokokokokokokokokokokokokokokokokokokokokokokokokokokokokokokokokokokokokokokokokokokokokokokokokokoko
kokokokokokokokokokokokokokokokokokokokokokokokokokokokokokokokokokokokokokokokokokokokokokokokokokokokokokokokokokokokokokokokokokokokokokokokokokokokokokokoko
kokokokokokokokokokokokokokokokokokokokokokokokokokokokokokokokokokokokokokokokokokokokokokokokokokokokokokokokokokokokokokokokokokokokokokokokokokokokokokokoko
kokokokokokokokokokokokokokokokokokokokokokokokokokokokokokokokokokokokokokokokokokokokokokokokokokokokokokokokokokokokokokokokokokokokokokokokokokokokokokokoko
kokokokokokokokokokokokokokokokokokokokokokokokokokokokokokokokokokokokokokokokokokokokokokokokokokokokokokokokokokokokokokokokokokokokokokokokokokokokokokokoko
kokokokokokokokokokokokokokokokokokokokokokokokokokokokokokokokokokokokokokokokokokokokokokokokokokokokokokokokokokokokokokokokokokokokokokokokokokokokokokokoko
kokokokokokokokokokokokokokokokokokokokokokokokokokokokokokokokokokokokokokokokokokokokokokokokokokokokokokokokokokokokokokokokokokokokokokokokokokokokokokokoko
kokokokokokokokokokokokokokokokokokokokokokokokokokokokokokokokokokokokokokokokokokokokokokokokokokokokokokokokokokokokokokokokokokokokokokokokokokokokokokokoko
kokokokokokokokokokokokokokokokokokokokokokokokokokokokokokokokokokokokokokokokokokokokokokokokokokokokokokokokokokokokokokokokokokokokokokokokokokokokokokokoko
kokokokokokokokokokokokokokokokokokokokokokokokokokokokokokokokokokokokokokokokokokokokokokokokokokokokokokokokokokokokokokokokokokokokokokokokokokokokokokokoko
kokokokokokokokokokokokokokokokokokokokokokokokokokokokokokokokokokokokokokokokokokokokokokokokokokokokokokokokokokokokokokokokokokokokokokokokokokokokokokokoko
kokokokokokokokokokokokokokokokokokokokokokokokokokokokokokokokokokokokokokokokokokokokokokokokokokokokokokokokokokokokokokokokokokokokokokokokokokokokokokokoko
kokokokokokokokokokokokokokokokokokokokokokokokokokokokokokokokokokokokokokokokokokokokokokokokokokokokokokokokokokokokokokokokokokokokokokokokokokokokokokokoko
kokokokokokokokokokokokokokokokokokokokokokokokokokokokokokokokokokokokokokokokokokokokokokokokokokokokokokokokokokokokokokokokokokokokokokokokokokokokokokokoko
kokokokokokokokokokokokokokokokokokokokokokokokokokokokokokokokokokokokokokokokokokokokokokokokokokokokokokokokokokokokokokokokokokokokokokokokokokokokokokokoko
kokokokokokokokokokokokokokokokokokokokokokokokokokokokokokokokokokokokokokokokokokokokokokokokokokokokokokokokokokokokokokokokokokokokokokokokokokokokokokokoko
kokokokokokokokokokokokokokokokokokokokokokokokokokokokokokokokokokokokokokokokokokokokokokokokokokokokokokokokokokokokokokokokokokokokokokokokokokokokokokokoko
kokokokokokokokokokokokokokokokokokokokokokokokokokokokokokokokokokokokokokokokokokokokokokokokokokokokokokokokokokokokokokokokokokokokokokokokokokokokokokokoko
kokokokokokokokokokokokokokokokokokokokokokokokokokokokokokokokokokokokokokokokokokokokokokokokokokokokokokokokokokokokokokokokokokokokokokokokokokokokokokokoko
kokokokokokokokokokokokokokokokokokokokokokokokokokokokokokokokokokokokokokokokokokokokokokokokokokokokokokokokokokokokokokokokokokokokokokokokokokokokokokokoko
kokokokokokokokokokokokokokokokokokokokokokokokokokokokokokokokokokokokokokokokokokokokokokokokokokokokokokokokokokokokokokokokokokokokokokokokokokokokokokokoko
kokokokokokokokokokokokokokokokokokokokokokokokokokokokokokokokokokokokokocLcLcLcLcLkokokokokokokokokokokokokokokokokokokokokokokokokokokokokokokokokokokokokoko
kokokokokokokokokokokokokokokokokokokokokokokokokokokokokokokokokokokokokocLCSCSCScLcLcLkokokokokokokokokokokokokokokokokokokokokokokokokokokokokokokokokokokoko
kokokokokokokokokokokokokokokokokokokokokokokokokokokokokokokokokokokokokocLCSXnCStduzcLkokokokokokokokokokokokokokokokokokokokokokokokokokokokokokokokokokokoko
kokokokokokokokokokokokokokokokokokokokokokokokokokokokokokokokokokokocLcLcLCSpSCSkWaWcLkoKdKdKdKdKdKdkokokokokokokokokokokokokokokokokokokokokokokokokokokokoko
kokokokokokokokokokokokokokokokokokokokokokokokokokokokokokokokokokokocLwmVRXHZrcfkEDzcLkoKdKwIadFWSKdKdKdkokokokokokokokokokokokokokokokokokokokokokokokokokoko
kokokokokokokokokokokokokokokokokokokokokokokokokokokokokokokokokokokocLQTJbWXrZpZhncLcLkoKdUipEFrMdGSWkiBkokokokokokokokokokokokokokokokokokokokokokokokokokoko
kokokokokokokokokokokokokokokokokokokokokokokokokokokokokokokokokokokocLcLcLcLcLcLqOcLkokoKdxoKhVlMdGSRQRQkokokokokokokokokokokokokokokokokokokokokokokokokokoko
kokokokokokokokokokokokokokokokokokokokokokokokokokokokokokokokokokokokoWCSuyxTnNsoeWCWCWCKdKdKdicbvKdKdRQkokokokokokokokokokokokokokokokokokokokokokokokokokoko
kokokokokokokokokokokokokokokokokokokokokokokokokokokokokokokokokokokokoWCCAvbpjGiUzBZDbAflCsYtHFhMdDRKdRQkokokokokokokokokokokokokokokokokokokokokokokokokokoko
kokokokokokokokokokokokokokokokokokokokokokokokokokokokokokokokokokokokoWCBFWCVWlNJkWCWCWCKdyaKdjXecKdKdRQkokokokokokokokokokokokokokokokokokokokokokokokokokoko
kokokokokokokokokokokokokokokokokokokokokokokokokokokokokokokokokokokokoWCWCWCJUPDqlWCkokoKdBDKdKdKdKddGRQkokokokokokokokokokokokokokokokokokokokokokokokokokoko
kokokokokokokokokokokokokokokokokokokokokokokokokokokokokokokokokokokokokokoWCWCWCWCWCkokodGDsVaKddGKdRQkokokokokokokokokokokokokokokokokokokokokokokokokokokoko
kokokokokokokokokokokokokokokokokokokokokokokokokokokokokokokokokokokokokokokokokokokokokokokokokokokokokokokokokokokokokokokokokokokokokokokokokokokokokokokoko
kokokokokokokokokokokokokokokokokokokokokokokokokokokokokokokokokokokokokokokokokokokokokokokokokokokokokokokokokokokokokokokokokokokokokokokokokokokokokokokoko
kokokokokokokokokokokokokokokokokokokokokokokokokokokokokokokokokokokokokokokokokokokokokokokokokokokokokokokokokokokokokokokokokokokokokokokokokokokokokokokoko
kokokokokokokokokokokokokokokokokokokokokokokokokokokokokokokokokokokokokokokokokokokokokokokokokokokokokokokokokokokokokokokokokokokokokokokokokokokokokokokoko
kokokokokokokokokokokokokokokokokokokokokokokokokokokokokokokokokokokokokokokokokokokokokokokokokokokokokokokokokokokokokokokokokokokokokokokokokokokokokokokoko
kokokokokokokokokokokokokokokokokokokokokokokokokokokokokokokokokokokokokokokokokokokokokokokokokokokokokokokokokokokokokokokokokokokokokokokokokokokokokokokoko
kokokokokokokokokokokokokokokokokokokokokokokokokokokokokokokokokokokokokokokokokokokokokokokokokokokokokokokokokokokokokokokokokokokokokokokokokokokokokokokoko
kokokokokokokokokokokokokokokokokokokokokokokokokokokokokokokokokokokokokokokokokokokokokokokokokokokokokokokokokokokokokokokokokokokokokokokokokokokokokokokoko
kokokokokokokokokokokokokokokokokokokokokokokokokokokokokokokokokokokokokokokokokokokokokokokokokokokokokokokokokokokokokokokokokokokokokokokokokokokokokokokoko
kokokokokokokokokokokokokokokokokokokokokokokokokokokokokokokokokokokokokokokokokokokokokokokokokokokokokokokokokokokokokokokokokokokokokokokokokokokokokokokoko
kokokokokokokokokokokokokokokokokokokokokokokokokokokokokokokokokokokokokokokokokokokokokokokokokokokokokokokokokokokokokokokokokokokokokokokokokokokokokokokoko
kokokokokokokokokokokokokokokokokokokokokokokokokokokokokokokokokokokokokokokokokokokokokokokokokokokokokokokokokokokokokokokokokokokokokokokokokokokokokokokoko
kokokokokokokokokokokokokokokokokokokokokokokokokokokokokokokokokokokokokokokokokokokokokokokokokokokokokokokokokokokokokokokokokokokokokokokokokokokokokokokoko
kokokokokokokokokokokokokokokokokokokokokokokokokokokokokokokokokokokokokokokokokokokokokokokokokokokokokokokokokokokokokokokokokokokokokokokokokokokokokokokoko
kokokokokokokokokokokokokokokokokokokokokokokokokokokokokokokokokokokokokokokokokokokokokokokokokokokokokokokokokokokokokokokokokokokokokokokokokokokokokokokoko
kokokokokokokokokokokokokokokokokokokokokokokokokokokokokokokokokokokokokokokokokokokokokokokokokokokokokokokokokokokokokokokokokokokokokokokokokokokokokokokoko
kokokokokokokokokokokokokokokokokokokokokokokokokokokokokokokokokokokokokokokokokokokokokokokokokokokokokokokokokokokokokokokokokokokokokokokokokokokokokokokoko
kokokokokokokokokokokokokokokokokokokokokokokokokokokokokokokokokokokokokokokokokokokokokokokokokokokokokokokokokokokokokokokokokokokokokokokokokokokokokokokoko
kokokokokokokokokokokokokokokokokokokokokokokokokokokokokokokokokokokokokokokokokokokokokokokokokokokokokokokokokokokokokokokokokokokokokokokokokokokokokokokoko
kokokokokokokokokokokokokokokokokokokokokokokokokokokokokokokokokokokokokokokokokokokokokokokokokokokokokokokokokokokokokokokokokokokokokokokokokokokokokokokoko
kokokokokokokokokokokokokokokokokokokokokokokokokokokokokokokokokokokokokokokokokokokokokokokokokokokokokokokokokokokokokokokokokokokokokokokokokokokokokokokoko
kokokokokokokokokokokokokokokokokokokokokokokokokokokokokokokokokokokokokokokokokokokokokokokokokokokokokokokokokokokokokokokokokokokokokokokokokokokokokokokoko
kokokokokokokokokokokokokokokokokokokokokokokokokokokokokokokokokokokokokokokokokokokokokokokokokokokokokokokokokokokokokokokokokokokokokokokokokokokokokokokoko
kokokokokokokokokokokokokokokokokokokokokokokokokokokokokokokokokokokokokokokokokokokokokokokokokokokokokokokokokokokokokokokokokokokokokokokokokokokokokokokoko
kokokokokokokokokokokokokokokokokokokokokokokokokokokokokokokokokokokokokokokokokokokokokokokokokokokokokokokokokokokokokokokokokokokokokokokokokokokokokokokoko
kokokokokokokokokokokokokokokokokokokokokokokokokokokokokokokokokokokokokokokokokokokokokokokokokokokokokokokokokokokokokokokokokokokokokokokokokokokokokokokoko
kokokokokokokokokokokokokokokokokokokokokokokokokokokokokokokokokokokokokokokokokokokokokokokokokokokokokokokokokokokokokokokokokokokokokokokokokokokokokokokoko
kokokokokokokokokokokokokokokokokokokokokokokokokokokokokokokokokokokokokokokokokokokokokokokokokokokokokokokokokokokokokokokokokokokokokokokokokokokokokokokoko
kokokokokokokokokokokokokokokokokokokokokokokokokokokokokokokokokokokokokokokokokokokokokokokokokokokokokokokokokokokokokokokokokokokokokokokokokokokokokokokoko
kokokokokokokokokokokokokokokokokokokokokokokokokokokokokokokokokokokokokokokokokokokokokokokokokokokokokokokokokokokokokokokokokokokokokokokokokokokokokokokoko
kokokokokokokokokokokokokokokokokokokokokokokokokokokokokokokokokokokokokokokokokokokokokokokokokokokokokokokokokokokokokokokokokokokokokokokokokokokokokokokoko
"}
